<java.lang.ProcessBuilder: java.lang.Process start()>/java.io.IOException.<init>/0	<java.io.IOException: void <init>(java.lang.String,java.lang.Throwable)>
<java.lang.ProcessBuilder: java.lang.Process start()>/java.io.IOException.getMessage/0	<java.lang.Throwable: java.lang.String getMessage()>
<java.lang.ProcessBuilder: java.lang.Process start()>/java.lang.ProcessImpl.start/0	<java.lang.ProcessImpl: java.lang.Process start(java.lang.String[],java.util.Map,java.lang.String,boolean)>
<java.lang.ProcessBuilder: java.lang.Process start()>/java.lang.System.getSecurityManager/0	<java.lang.System: java.lang.SecurityManager getSecurityManager()>
<java.lang.ProcessBuilder: java.lang.Process start()>/java.util.List.size/0	<java.util.ArrayList: int size()>
<java.lang.ProcessBuilder: java.lang.Process start()>/java.util.List.toArray/0	<java.util.ArrayList: java.lang.Object[] toArray(java.lang.Object[])>
<java.lang.ProcessImpl: java.lang.Process start(java.lang.String[],java.util.Map,java.lang.String,boolean)>/java.lang.ProcessEnvironment.toEnvironmentBlock/0	<java.lang.ProcessEnvironment: byte[] toEnvironmentBlock(java.util.Map,int[])>
<java.lang.ProcessImpl: java.lang.Process start(java.lang.String[],java.util.Map,java.lang.String,boolean)>/java.lang.ProcessImpl.toCString/0	<java.lang.ProcessImpl: byte[] toCString(java.lang.String)>
<java.lang.ProcessImpl: java.lang.Process start(java.lang.String[],java.util.Map,java.lang.String,boolean)>/java.lang.ProcessImpl.toCString/1	<java.lang.ProcessImpl: byte[] toCString(java.lang.String)>
<java.lang.ProcessImpl: java.lang.Process start(java.lang.String[],java.util.Map,java.lang.String,boolean)>/java.lang.UNIXProcess.<init>/0	<java.lang.UNIXProcess: void <init>(byte[],byte[],int,byte[],int,byte[],boolean)>
<java.lang.ProcessImpl: void <clinit>()>/java.lang.Class.desiredAssertionStatus/0	<java.lang.Class: boolean desiredAssertionStatus()>
<java.lang.Runtime: java.lang.Process exec(java.lang.String[],java.lang.String[],java.io.File)>/java.lang.ProcessBuilder.directory/0	<java.lang.ProcessBuilder: java.lang.ProcessBuilder directory(java.io.File)>
<java.lang.Runtime: java.lang.Process exec(java.lang.String[],java.lang.String[],java.io.File)>/java.lang.ProcessBuilder.start/0	<java.lang.ProcessBuilder: java.lang.Process start()>
<java.lang.UNIXProcess$1$1: void run()>/java.lang.UNIXProcess$Gate.exit/0	<java.lang.UNIXProcess$Gate: void exit()>
<java.lang.UNIXProcess$1$1: void run()>/java.lang.UNIXProcess$Gate.setException/0	<java.lang.UNIXProcess$Gate: void setException(java.io.IOException)>
<java.lang.UNIXProcess$1$1: void run()>/java.lang.UNIXProcess.access$200/0	<java.lang.UNIXProcess: java.io.FileDescriptor access$200(java.lang.UNIXProcess)>
<java.lang.UNIXProcess$1$1: void run()>/java.lang.UNIXProcess.access$300/0	<java.lang.UNIXProcess: java.io.FileDescriptor access$300(java.lang.UNIXProcess)>
<java.lang.UNIXProcess$1$1: void run()>/java.lang.UNIXProcess.access$400/0	<java.lang.UNIXProcess: java.io.FileDescriptor access$400(java.lang.UNIXProcess)>
<java.lang.UNIXProcess$1$1: void run()>/java.lang.UNIXProcess.access$500/0	<java.lang.UNIXProcess: int access$500(java.lang.UNIXProcess,byte[],byte[],int,byte[],int,byte[],boolean,java.io.FileDescriptor,java.io.FileDescriptor,java.io.FileDescriptor)>
<java.lang.UNIXProcess$1: java.lang.Object run()>/java.lang.UNIXProcess$1$1.<init>/0	<java.lang.UNIXProcess$1$1: void <init>(java.lang.UNIXProcess$1,java.lang.String)>
<java.lang.UNIXProcess$Gate: void <init>(java.lang.UNIXProcess$1)>/java.lang.UNIXProcess$Gate.<init>/0	<java.lang.UNIXProcess$Gate: void <init>()>
<java.lang.UNIXProcess: void <init>(byte[],byte[],int,byte[],int,byte[],boolean)>/java.io.FileDescriptor.<init>/0	<java.io.FileDescriptor: void <init>()>
<java.lang.UNIXProcess: void <init>(byte[],byte[],int,byte[],int,byte[],boolean)>/java.io.FileDescriptor.<init>/1	<java.io.FileDescriptor: void <init>()>
<java.lang.UNIXProcess: void <init>(byte[],byte[],int,byte[],int,byte[],boolean)>/java.io.FileDescriptor.<init>/2	<java.io.FileDescriptor: void <init>()>
<java.lang.UNIXProcess: void <init>(byte[],byte[],int,byte[],int,byte[],boolean)>/java.io.IOException.<init>/0	<java.io.IOException: void <init>(java.lang.String)>
<java.lang.UNIXProcess: void <init>(byte[],byte[],int,byte[],int,byte[],boolean)>/java.lang.Process.<init>/0	<java.lang.Process: void <init>()>
<java.lang.UNIXProcess: void <init>(byte[],byte[],int,byte[],int,byte[],boolean)>/java.lang.UNIXProcess$1.<init>/0	<java.lang.UNIXProcess$1: void <init>(java.lang.UNIXProcess,byte[],byte[],int,byte[],int,byte[],boolean,java.lang.UNIXProcess$Gate)>
<java.lang.UNIXProcess: void <init>(byte[],byte[],int,byte[],int,byte[],boolean)>/java.lang.UNIXProcess$Gate.<init>/0	<java.lang.UNIXProcess$Gate: void <init>(java.lang.UNIXProcess$1)>
<java.lang.UNIXProcess: void <init>(byte[],byte[],int,byte[],int,byte[],boolean)>/java.lang.UNIXProcess$Gate.getException/0	<java.lang.UNIXProcess$Gate: java.io.IOException getException()>
<java.lang.UNIXProcess: void <init>(byte[],byte[],int,byte[],int,byte[],boolean)>/java.lang.UNIXProcess$Gate.waitForExit/0	<java.lang.UNIXProcess$Gate: void waitForExit()>
<org.eclipse.core.internal.content.BasicDescription: org.eclipse.core.runtime.content.IContentType getContentType()>/org.eclipse.core.internal.content.IContentTypeInfo.getContentType/0	<org.eclipse.core.internal.content.ContentType: org.eclipse.core.internal.content.ContentType getContentType()>
<org.eclipse.core.internal.events.NodeIDMap: int getIndex(long)>/org.eclipse.core.internal.events.NodeIDMap.hashFor/0	<org.eclipse.core.internal.events.NodeIDMap: int hashFor(long,int)>
<org.eclipse.core.internal.events.NodeIDMap: org.eclipse.core.runtime.IPath getNewPath(long)>/org.eclipse.core.internal.events.NodeIDMap.getIndex/0	<org.eclipse.core.internal.events.NodeIDMap: int getIndex(long)>
<org.eclipse.core.internal.events.NodeIDMap: org.eclipse.core.runtime.IPath getOldPath(long)>/org.eclipse.core.internal.events.NodeIDMap.getIndex/0	<org.eclipse.core.internal.events.NodeIDMap: int getIndex(long)>
<org.eclipse.core.internal.events.ResourceDelta: void checkForMarkerDeltas()>/java.util.Map.get/0	<java.util.HashMap: java.lang.Object get(java.lang.Object)>
<org.eclipse.core.internal.events.ResourceDelta: void checkForMarkerDeltas()>/org.eclipse.core.internal.resources.MarkerSet.size/0	<org.eclipse.core.internal.resources.MarkerSet: int size()>
<org.eclipse.core.internal.events.ResourceDelta: void fixMovesAndMarkers(org.eclipse.core.internal.watson.ElementTree)>/org.eclipse.core.internal.events.NodeIDMap.getNewPath/0	<org.eclipse.core.internal.events.NodeIDMap: org.eclipse.core.runtime.IPath getNewPath(long)>
<org.eclipse.core.internal.events.ResourceDelta: void fixMovesAndMarkers(org.eclipse.core.internal.watson.ElementTree)>/org.eclipse.core.internal.events.NodeIDMap.getOldPath/0	<org.eclipse.core.internal.events.NodeIDMap: org.eclipse.core.runtime.IPath getOldPath(long)>
<org.eclipse.core.internal.events.ResourceDelta: void fixMovesAndMarkers(org.eclipse.core.internal.watson.ElementTree)>/org.eclipse.core.internal.events.NodeIDMap.isEmpty/0	<org.eclipse.core.internal.events.NodeIDMap: boolean isEmpty()>
<org.eclipse.core.internal.resources.LocalMetaArea: org.eclipse.core.runtime.IPath locationFor(org.eclipse.core.resources.IResource)>/org.eclipse.core.resources.IProject.getName/0	<org.eclipse.core.internal.resources.Resource: java.lang.String getName()>
<org.eclipse.jdt.core.JavaCore: org.eclipse.jdt.core.IClasspathEntry getResolvedClasspathEntry(org.eclipse.jdt.core.IClasspathEntry)>/java.io.File.getName/0	<java.io.File: java.lang.String getName()>
<org.eclipse.jdt.internal.core.ClasspathEntry: org.eclipse.jdt.core.IJavaModelStatus validateClasspathEntry(org.eclipse.jdt.core.IJavaProject,org.eclipse.jdt.core.IClasspathEntry,boolean,boolean)>/java.io.File.getName/0	<java.io.File: java.lang.String getName()>
<org.eclipse.osgi.framework.internal.core.ServiceRegistrationImpl: org.eclipse.osgi.framework.internal.core.ServiceRegistrationImpl$Properties createProperties(java.util.Dictionary)>/java.lang.Integer.intValue/0	<java.lang.Integer: int intValue()>
<java.awt.Component: boolean prepareImage(java.awt.Image,int,int,java.awt.image.ImageObserver)>/java.awt.Component.getToolkit/1	<java.awt.Component: java.awt.Toolkit getToolkit()>
<java.awt.Component: boolean prepareImage(java.awt.Image,int,int,java.awt.image.ImageObserver)>/java.awt.Toolkit.prepareImage/1	<sun.awt.SunToolkit: boolean prepareImage(java.awt.Image,int,int,java.awt.image.ImageObserver)>
<java.awt.Component: int checkImage(java.awt.Image,int,int,java.awt.image.ImageObserver)>/java.awt.Component.getToolkit/1	<java.awt.Component: java.awt.Toolkit getToolkit()>
<java.awt.Component: int checkImage(java.awt.Image,int,int,java.awt.image.ImageObserver)>/java.awt.Toolkit.checkImage/1	<sun.awt.SunToolkit: int checkImage(java.awt.Image,int,int,java.awt.image.ImageObserver)>
<java.awt.ImageMediaEntry: boolean imageUpdate(java.awt.Image,int,int,int,int,int)>/java.awt.ImageMediaEntry.parseflags/0	<java.awt.ImageMediaEntry: int parseflags(int)>
<java.awt.ImageMediaEntry: boolean imageUpdate(java.awt.Image,int,int,int,int,int)>/java.awt.ImageMediaEntry.setStatus/0	<java.awt.MediaEntry: void setStatus(int)>
<java.awt.ImageMediaEntry: int getStatus(boolean,boolean)>/java.awt.Component.checkImage/0	<java.awt.Component: int checkImage(java.awt.Image,int,int,java.awt.image.ImageObserver)>
<java.awt.ImageMediaEntry: int getStatus(boolean,boolean)>/java.awt.ImageMediaEntry.parseflags/0	<java.awt.ImageMediaEntry: int parseflags(int)>
<java.awt.ImageMediaEntry: int getStatus(boolean,boolean)>/java.awt.ImageMediaEntry.setStatus/1	<java.awt.MediaEntry: void setStatus(int)>
<java.awt.ImageMediaEntry: int getStatus(boolean,boolean)>/java.awt.MediaEntry.getStatus/0	<java.awt.MediaEntry: int getStatus(boolean,boolean)>
<java.awt.ImageMediaEntry: void startLoad()>/java.awt.Component.prepareImage/0	<java.awt.Component: boolean prepareImage(java.awt.Image,int,int,java.awt.image.ImageObserver)>
<java.awt.ImageMediaEntry: void startLoad()>/java.awt.ImageMediaEntry.setStatus/0	<java.awt.MediaEntry: void setStatus(int)>
<java.awt.MediaEntry: int getStatus(boolean,boolean)>/java.awt.MediaEntry.startLoad/0	<java.awt.ImageMediaEntry: void startLoad()>
<java.awt.MediaEntry: void setStatus(int)>/java.awt.MediaTracker.setDone/0	<java.awt.MediaTracker: void setDone()>
<java.awt.MediaTracker: boolean isErrorAny()>/java.awt.MediaEntry.getStatus/0	<java.awt.ImageMediaEntry: int getStatus(boolean,boolean)>
<java.awt.MediaTracker: int statusAll(boolean,boolean)>/java.awt.MediaEntry.getStatus/0	<java.awt.ImageMediaEntry: int getStatus(boolean,boolean)>
<java.awt.MediaTracker: int statusID(int,boolean,boolean)>/java.awt.MediaEntry.getID/0	<java.awt.MediaEntry: int getID()>
<java.awt.MediaTracker: int statusID(int,boolean,boolean)>/java.awt.MediaEntry.getStatus/0	<java.awt.ImageMediaEntry: int getStatus(boolean,boolean)>
<java.awt.MediaTracker: void removeImage(java.awt.Image,int)>/java.awt.MediaEntry.cancel/0	<java.awt.MediaEntry: void cancel()>
<java.awt.MediaTracker: void removeImage(java.awt.Image,int)>/java.awt.MediaEntry.getID/0	<java.awt.MediaEntry: int getID()>
<java.awt.MediaTracker: void removeImage(java.awt.Image,int)>/java.awt.MediaEntry.getMedia/0	<java.awt.ImageMediaEntry: java.lang.Object getMedia()>
<java.io.FilterInputStream: int read(byte[],int,int)>/java.io.InputStream.read/0	<java.io.BufferedInputStream: int read(byte[],int,int)>
<javax.swing.plaf.basic.BasicButtonListener: javax.swing.InputMap getInputMap(int,javax.swing.JComponent)>/javax.swing.plaf.basic.BasicButtonUI.getPropertyPrefix/0	<javax.swing.plaf.basic.BasicButtonUI: java.lang.String getPropertyPrefix()>
<javax.swing.plaf.basic.BasicButtonListener: javax.swing.InputMap getInputMap(int,javax.swing.JComponent)>/javax.swing.plaf.basic.BasicButtonUI.getPropertyPrefix/0	<javax.swing.plaf.basic.BasicCheckBoxUI: java.lang.String getPropertyPrefix()>
<javax.swing.plaf.basic.BasicButtonListener: javax.swing.InputMap getInputMap(int,javax.swing.JComponent)>/javax.swing.plaf.basic.BasicButtonUI.getPropertyPrefix/0	<javax.swing.plaf.basic.BasicRadioButtonUI: java.lang.String getPropertyPrefix()>
<javax.swing.plaf.basic.BasicButtonListener: javax.swing.InputMap getInputMap(int,javax.swing.JComponent)>/javax.swing.plaf.basic.BasicButtonUI.getPropertyPrefix/0	<javax.swing.plaf.basic.BasicToggleButtonUI: java.lang.String getPropertyPrefix()>
<javax.swing.plaf.basic.BasicButtonListener: void focusGained(java.awt.event.FocusEvent)>/javax.swing.plaf.basic.BasicButtonUI.getPropertyPrefix/0	<javax.swing.plaf.basic.BasicButtonUI: java.lang.String getPropertyPrefix()>
<javax.swing.plaf.basic.BasicButtonListener: void focusLost(java.awt.event.FocusEvent)>/javax.swing.plaf.basic.BasicButtonUI.getPropertyPrefix/0	<javax.swing.plaf.basic.BasicButtonUI: java.lang.String getPropertyPrefix()>
<javax.swing.text.GlyphPainter1: float getAscent(javax.swing.text.GlyphView)>/java.awt.FontMetrics.getAscent/0	<sun.font.FontDesignMetrics: int getAscent()>
<javax.swing.text.GlyphPainter1: float getAscent(javax.swing.text.GlyphView)>/javax.swing.text.GlyphPainter1.sync/0	<javax.swing.text.GlyphPainter1: void sync(javax.swing.text.GlyphView)>
<javax.swing.text.GlyphPainter1: float getDescent(javax.swing.text.GlyphView)>/java.awt.FontMetrics.getDescent/0	<sun.font.FontDesignMetrics: int getDescent()>
<javax.swing.text.GlyphPainter1: float getDescent(javax.swing.text.GlyphView)>/javax.swing.text.GlyphPainter1.sync/0	<javax.swing.text.GlyphPainter1: void sync(javax.swing.text.GlyphView)>
<javax.swing.text.GlyphPainter1: float getHeight(javax.swing.text.GlyphView)>/java.awt.FontMetrics.getHeight/0	<sun.font.FontDesignMetrics: int getHeight()>
<javax.swing.text.GlyphPainter1: float getHeight(javax.swing.text.GlyphView)>/javax.swing.text.GlyphPainter1.sync/0	<javax.swing.text.GlyphPainter1: void sync(javax.swing.text.GlyphView)>
<javax.swing.text.GlyphPainter1: float getSpan(javax.swing.text.GlyphView,int,int,javax.swing.text.TabExpander,float)>/javax.swing.text.GlyphPainter1.getJustificationData/0	<javax.swing.text.GlyphPainter1: int[] getJustificationData(javax.swing.text.GlyphView)>
<javax.swing.text.GlyphPainter1: float getSpan(javax.swing.text.GlyphView,int,int,javax.swing.text.TabExpander,float)>/javax.swing.text.GlyphPainter1.sync/0	<javax.swing.text.GlyphPainter1: void sync(javax.swing.text.GlyphView)>
<javax.swing.text.GlyphPainter1: float getSpan(javax.swing.text.GlyphView,int,int,javax.swing.text.TabExpander,float)>/javax.swing.text.GlyphView.getText/0	<javax.swing.text.GlyphView: javax.swing.text.Segment getText(int,int)>
<javax.swing.text.GlyphPainter1: float getSpan(javax.swing.text.GlyphView,int,int,javax.swing.text.TabExpander,float)>/javax.swing.text.SegmentCache.releaseSharedSegment/0	<javax.swing.text.SegmentCache: void releaseSharedSegment(javax.swing.text.Segment)>
<javax.swing.text.GlyphPainter1: float getSpan(javax.swing.text.GlyphView,int,int,javax.swing.text.TabExpander,float)>/javax.swing.text.Utilities.getTabbedTextWidth/0	<javax.swing.text.Utilities: int getTabbedTextWidth(javax.swing.text.View,javax.swing.text.Segment,java.awt.FontMetrics,int,javax.swing.text.TabExpander,int,int[])>
<javax.swing.text.GlyphPainter1: int getBoundedPosition(javax.swing.text.GlyphView,int,float,float)>/javax.swing.text.GlyphPainter1.getJustificationData/0	<javax.swing.text.GlyphPainter1: int[] getJustificationData(javax.swing.text.GlyphView)>
<javax.swing.text.GlyphPainter1: int getBoundedPosition(javax.swing.text.GlyphView,int,float,float)>/javax.swing.text.GlyphPainter1.sync/0	<javax.swing.text.GlyphPainter1: void sync(javax.swing.text.GlyphView)>
<javax.swing.text.GlyphPainter1: int getBoundedPosition(javax.swing.text.GlyphView,int,float,float)>/javax.swing.text.GlyphView.getEndOffset/0	<javax.swing.text.GlyphView: int getEndOffset()>
<javax.swing.text.GlyphPainter1: int getBoundedPosition(javax.swing.text.GlyphView,int,float,float)>/javax.swing.text.GlyphView.getTabExpander/0	<javax.swing.text.GlyphView: javax.swing.text.TabExpander getTabExpander()>
<javax.swing.text.GlyphPainter1: int getBoundedPosition(javax.swing.text.GlyphView,int,float,float)>/javax.swing.text.GlyphView.getText/0	<javax.swing.text.GlyphView: javax.swing.text.Segment getText(int,int)>
<javax.swing.text.GlyphPainter1: int getBoundedPosition(javax.swing.text.GlyphView,int,float,float)>/javax.swing.text.SegmentCache.releaseSharedSegment/0	<javax.swing.text.SegmentCache: void releaseSharedSegment(javax.swing.text.Segment)>
<javax.swing.text.GlyphPainter1: int getBoundedPosition(javax.swing.text.GlyphView,int,float,float)>/javax.swing.text.Utilities.getTabbedTextOffset/0	<javax.swing.text.Utilities: int getTabbedTextOffset(javax.swing.text.View,javax.swing.text.Segment,java.awt.FontMetrics,int,int,javax.swing.text.TabExpander,int,boolean,int[])>
<javax.swing.text.GlyphPainter1: int[] getJustificationData(javax.swing.text.GlyphView)>/javax.swing.text.GlyphView.getParent/0	<javax.swing.text.View: javax.swing.text.View getParent()>
<javax.swing.text.GlyphPainter1: void sync(javax.swing.text.GlyphView)>/java.awt.Container.getFontMetrics/0	<javax.swing.JComponent: java.awt.FontMetrics getFontMetrics(java.awt.Font)>
<javax.swing.text.GlyphPainter1: void sync(javax.swing.text.GlyphView)>/java.awt.Font.equals/0	<java.awt.Font: boolean equals(java.lang.Object)>
<javax.swing.text.GlyphPainter1: void sync(javax.swing.text.GlyphView)>/java.awt.FontMetrics.getFont/0	<java.awt.FontMetrics: java.awt.Font getFont()>
<javax.swing.text.GlyphPainter1: void sync(javax.swing.text.GlyphView)>/javax.swing.text.GlyphView.getContainer/0	<javax.swing.text.View: java.awt.Container getContainer()>
<javax.swing.text.GlyphPainter1: void sync(javax.swing.text.GlyphView)>/javax.swing.text.GlyphView.getFont/0	<javax.swing.text.LabelView: java.awt.Font getFont()>
<javax.swing.text.GlyphView: float getAlignment(int)>/javax.swing.text.GlyphView$GlyphPainter.getAscent/0	<javax.swing.text.GlyphPainter1: float getAscent(javax.swing.text.GlyphView)>
<javax.swing.text.GlyphView: float getAlignment(int)>/javax.swing.text.GlyphView$GlyphPainter.getDescent/0	<javax.swing.text.GlyphPainter1: float getDescent(javax.swing.text.GlyphView)>
<javax.swing.text.GlyphView: float getAlignment(int)>/javax.swing.text.GlyphView$GlyphPainter.getHeight/0	<javax.swing.text.GlyphPainter1: float getHeight(javax.swing.text.GlyphView)>
<javax.swing.text.GlyphView: float getPreferredSpan(int)>/javax.swing.text.GlyphView$GlyphPainter.getHeight/0	<javax.swing.text.GlyphPainter1: float getHeight(javax.swing.text.GlyphView)>
<javax.swing.text.GlyphView: float getPreferredSpan(int)>/javax.swing.text.GlyphView$GlyphPainter.getSpan/0	<javax.swing.text.GlyphPainter1: float getSpan(javax.swing.text.GlyphView,int,int,javax.swing.text.TabExpander,float)>
<javax.swing.text.GlyphView: float getTabbedSpan(float,javax.swing.text.TabExpander)>/javax.swing.text.GlyphView$GlyphPainter.getSpan/0	<javax.swing.text.GlyphPainter1: float getSpan(javax.swing.text.GlyphView,int,int,javax.swing.text.TabExpander,float)>
<javax.swing.text.GlyphView: int getBreakWeight(int,float,float)>/javax.swing.text.GlyphView$GlyphPainter.getBoundedPosition/0	<javax.swing.text.GlyphPainter1: int getBoundedPosition(javax.swing.text.GlyphView,int,float,float)>
<net.sf.freecol.client.gui.i18n.Messages: net.sf.freecol.common.model.StringTemplate getLabel(net.sf.freecol.common.model.Unit)>/net.sf.freecol.common.model.StringTemplate.add/1	<net.sf.freecol.common.model.StringTemplate: net.sf.freecol.common.model.StringTemplate add(java.lang.String)>
<net.sf.freecol.client.gui.i18n.Messages: net.sf.freecol.common.model.StringTemplate getLabel(net.sf.freecol.common.model.Unit)>/net.sf.freecol.common.model.StringTemplate.addName/2	<net.sf.freecol.common.model.StringTemplate: net.sf.freecol.common.model.StringTemplate addName(java.lang.String)>
<net.sf.freecol.client.gui.i18n.Messages: net.sf.freecol.common.model.StringTemplate getLabel(net.sf.freecol.common.model.Unit)>/net.sf.freecol.common.model.StringTemplate.addStringTemplate/0	<net.sf.freecol.common.model.StringTemplate: net.sf.freecol.common.model.StringTemplate addStringTemplate(net.sf.freecol.common.model.StringTemplate)>
<sun.awt.SunToolkit: int checkImage(java.awt.Image,int,int,java.awt.image.ImageObserver)>/sun.awt.image.ImageRepresentation.check/0	<sun.awt.image.ImageRepresentation: int check(java.awt.image.ImageObserver)>
<sun.awt.SunToolkit: int checkImage(java.awt.Image,int,int,java.awt.image.ImageObserver)>/sun.awt.image.ToolkitImage.check/0	<sun.awt.image.ToolkitImage: int check(java.awt.image.ImageObserver)>
<sun.awt.SunToolkit: int checkImage(java.awt.Image,int,int,java.awt.image.ImageObserver)>/sun.awt.image.ToolkitImage.getImageRep/0	<sun.awt.image.ToolkitImage: sun.awt.image.ImageRepresentation getImageRep()>
<sun.awt.image.ImageRepresentation: int check(java.awt.image.ImageObserver)>/sun.awt.image.ImageRepresentation.addWatcher/0	<sun.awt.image.ImageWatched: void addWatcher(java.awt.image.ImageObserver)>
<sun.awt.image.ImageRepresentation: int check(java.awt.image.ImageObserver)>/sun.awt.image.InputStreamImageSource.checkSecurity/0	<sun.awt.image.ByteArrayImageSource: boolean checkSecurity(java.lang.Object,boolean)>
<sun.awt.image.ImageRepresentation: int check(java.awt.image.ImageObserver)>/sun.awt.image.InputStreamImageSource.checkSecurity/0	<sun.awt.image.FileImageSource: boolean checkSecurity(java.lang.Object,boolean)>
<sun.awt.image.ImageRepresentation: int check(java.awt.image.ImageObserver)>/sun.awt.image.InputStreamImageSource.checkSecurity/0	<sun.awt.image.URLImageSource: boolean checkSecurity(java.lang.Object,boolean)>
<sun.awt.image.ImageWatched$WeakLink: boolean newInfo(java.awt.Image,int,int,int,int,int)>/java.awt.image.ImageObserver.imageUpdate/0	<java.awt.ImageMediaEntry: boolean imageUpdate(java.awt.Image,int,int,int,int,int)>
<sun.awt.image.ToolkitImage: int check(java.awt.image.ImageObserver)>/sun.awt.image.InputStreamImageSource.checkSecurity/0	<sun.awt.image.ByteArrayImageSource: boolean checkSecurity(java.lang.Object,boolean)>
<sun.awt.image.ToolkitImage: int check(java.awt.image.ImageObserver)>/sun.awt.image.InputStreamImageSource.checkSecurity/0	<sun.awt.image.FileImageSource: boolean checkSecurity(java.lang.Object,boolean)>
<sun.awt.image.ToolkitImage: int check(java.awt.image.ImageObserver)>/sun.awt.image.InputStreamImageSource.checkSecurity/0	<sun.awt.image.URLImageSource: boolean checkSecurity(java.lang.Object,boolean)>
<sun.awt.image.ToolkitImage: int check(java.awt.image.ImageObserver)>/sun.awt.image.ToolkitImage.addWatcher/0	<sun.awt.image.ToolkitImage: void addWatcher(java.awt.image.ImageObserver,boolean)>
<sun.nio.ch.Util: void free(java.nio.ByteBuffer)>/sun.misc.Cleaner.clean/0	<sun.misc.Cleaner: void clean()>
<com.itextpdf.text.pdf.MappedRandomAccessFile$1: java.lang.Boolean run()>/java.lang.Class.getMethod/1	<java.lang.Class: java.lang.reflect.Method getMethod(java.lang.String,java.lang.Class[])>
<java.util.regex.Pattern$8: boolean isSatisfiedBy(int)>/java.util.regex.Pattern$CharProperty.isSatisfiedBy/0	<java.util.regex.Pattern$BitClass: boolean isSatisfiedBy(int)>
<javax.swing.JEditorPane$PlainEditorKit: javax.swing.text.View create(javax.swing.text.Element)>/java.lang.Object.equals/0	<java.lang.Boolean: boolean equals(java.lang.Object)>
<javax.swing.JEditorPane$PlainEditorKit: javax.swing.text.View create(javax.swing.text.Element)>/javax.swing.text.Document.getProperty/0	<javax.swing.text.AbstractDocument: java.lang.Object getProperty(java.lang.Object)>
<javax.swing.JEditorPane$PlainEditorKit: javax.swing.text.View create(javax.swing.text.Element)>/javax.swing.text.Element.getDocument/0	<javax.swing.text.AbstractDocument$AbstractElement: javax.swing.text.Document getDocument()>
<javax.swing.JEditorPane$PlainEditorKit: javax.swing.text.View create(javax.swing.text.Element)>/javax.swing.text.WrappedPlainView.<init>/0	<javax.swing.text.WrappedPlainView: void <init>(javax.swing.text.Element)>
<javax.swing.plaf.basic.BasicTextUI: void modelChanged()>/javax.swing.text.ViewFactory.create/0	<javax.swing.JEditorPane$PlainEditorKit: javax.swing.text.View create(javax.swing.text.Element)>
<javax.swing.plaf.synth.SynthDefaultLookup: java.lang.Object getDefault(javax.swing.JComponent,javax.swing.plaf.ComponentUI,java.lang.String)>/sun.swing.plaf.synth.SynthUI.getContext/0	<javax.swing.plaf.synth.SynthButtonUI: javax.swing.plaf.synth.SynthContext getContext(javax.swing.JComponent)>
<javax.swing.text.GlyphPainter1: int viewToModel(javax.swing.text.GlyphView,float,float,java.awt.Shape,javax.swing.text.Position$Bias[])>/javax.swing.text.GlyphPainter1.getJustificationData/0	<javax.swing.text.GlyphPainter1: int[] getJustificationData(javax.swing.text.GlyphView)>
<javax.swing.text.GlyphPainter1: int viewToModel(javax.swing.text.GlyphView,float,float,java.awt.Shape,javax.swing.text.Position$Bias[])>/javax.swing.text.GlyphPainter1.sync/0	<javax.swing.text.GlyphPainter1: void sync(javax.swing.text.GlyphView)>
<javax.swing.text.GlyphPainter1: int viewToModel(javax.swing.text.GlyphView,float,float,java.awt.Shape,javax.swing.text.Position$Bias[])>/javax.swing.text.GlyphView.getEndOffset/0	<javax.swing.text.GlyphView: int getEndOffset()>
<javax.swing.text.GlyphPainter1: int viewToModel(javax.swing.text.GlyphView,float,float,java.awt.Shape,javax.swing.text.Position$Bias[])>/javax.swing.text.GlyphView.getStartOffset/0	<javax.swing.text.GlyphView: int getStartOffset()>
<javax.swing.text.GlyphPainter1: int viewToModel(javax.swing.text.GlyphView,float,float,java.awt.Shape,javax.swing.text.Position$Bias[])>/javax.swing.text.GlyphView.getTabExpander/0	<javax.swing.text.GlyphView: javax.swing.text.TabExpander getTabExpander()>
<javax.swing.text.GlyphPainter1: int viewToModel(javax.swing.text.GlyphView,float,float,java.awt.Shape,javax.swing.text.Position$Bias[])>/javax.swing.text.GlyphView.getText/0	<javax.swing.text.GlyphView: javax.swing.text.Segment getText(int,int)>
<javax.swing.text.GlyphPainter1: int viewToModel(javax.swing.text.GlyphView,float,float,java.awt.Shape,javax.swing.text.Position$Bias[])>/javax.swing.text.SegmentCache.releaseSharedSegment/0	<javax.swing.text.SegmentCache: void releaseSharedSegment(javax.swing.text.Segment)>
<javax.swing.text.GlyphPainter1: int viewToModel(javax.swing.text.GlyphView,float,float,java.awt.Shape,javax.swing.text.Position$Bias[])>/javax.swing.text.Utilities.getTabbedTextOffset/0	<javax.swing.text.Utilities: int getTabbedTextOffset(javax.swing.text.View,javax.swing.text.Segment,java.awt.FontMetrics,int,int,javax.swing.text.TabExpander,int,int[])>
<javax.swing.text.GlyphPainter1: java.awt.Shape modelToView(javax.swing.text.GlyphView,int,javax.swing.text.Position$Bias,java.awt.Shape)>/java.awt.FontMetrics.getHeight/0	<sun.font.FontDesignMetrics: int getHeight()>
<javax.swing.text.GlyphPainter1: java.awt.Shape modelToView(javax.swing.text.GlyphView,int,javax.swing.text.Position$Bias,java.awt.Shape)>/java.awt.FontMetrics.getHeight/1	<sun.font.FontDesignMetrics: int getHeight()>
<javax.swing.text.GlyphPainter1: java.awt.Shape modelToView(javax.swing.text.GlyphView,int,javax.swing.text.Position$Bias,java.awt.Shape)>/java.awt.Rectangle.<init>/0	<java.awt.Rectangle: void <init>(int,int,int,int)>
<javax.swing.text.GlyphPainter1: java.awt.Shape modelToView(javax.swing.text.GlyphView,int,javax.swing.text.Position$Bias,java.awt.Shape)>/java.awt.Rectangle.<init>/1	<java.awt.Rectangle: void <init>(int,int,int,int)>
<javax.swing.text.GlyphPainter1: java.awt.Shape modelToView(javax.swing.text.GlyphView,int,javax.swing.text.Position$Bias,java.awt.Shape)>/javax.swing.text.GlyphPainter1.getJustificationData/0	<javax.swing.text.GlyphPainter1: int[] getJustificationData(javax.swing.text.GlyphView)>
<javax.swing.text.GlyphPainter1: java.awt.Shape modelToView(javax.swing.text.GlyphView,int,javax.swing.text.Position$Bias,java.awt.Shape)>/javax.swing.text.GlyphPainter1.sync/0	<javax.swing.text.GlyphPainter1: void sync(javax.swing.text.GlyphView)>
<javax.swing.text.GlyphPainter1: java.awt.Shape modelToView(javax.swing.text.GlyphView,int,javax.swing.text.Position$Bias,java.awt.Shape)>/javax.swing.text.GlyphView.getEndOffset/0	<javax.swing.text.GlyphView: int getEndOffset()>
<javax.swing.text.GlyphPainter1: java.awt.Shape modelToView(javax.swing.text.GlyphView,int,javax.swing.text.Position$Bias,java.awt.Shape)>/javax.swing.text.GlyphView.getStartOffset/0	<javax.swing.text.GlyphView: int getStartOffset()>
<javax.swing.text.GlyphPainter1: java.awt.Shape modelToView(javax.swing.text.GlyphView,int,javax.swing.text.Position$Bias,java.awt.Shape)>/javax.swing.text.GlyphView.getTabExpander/0	<javax.swing.text.GlyphView: javax.swing.text.TabExpander getTabExpander()>
<javax.swing.text.GlyphPainter1: java.awt.Shape modelToView(javax.swing.text.GlyphView,int,javax.swing.text.Position$Bias,java.awt.Shape)>/javax.swing.text.GlyphView.getText/0	<javax.swing.text.GlyphView: javax.swing.text.Segment getText(int,int)>
<javax.swing.text.GlyphPainter1: java.awt.Shape modelToView(javax.swing.text.GlyphView,int,javax.swing.text.Position$Bias,java.awt.Shape)>/javax.swing.text.SegmentCache.releaseSharedSegment/0	<javax.swing.text.SegmentCache: void releaseSharedSegment(javax.swing.text.Segment)>
<javax.swing.text.GlyphPainter1: java.awt.Shape modelToView(javax.swing.text.GlyphView,int,javax.swing.text.Position$Bias,java.awt.Shape)>/javax.swing.text.Utilities.getTabbedTextWidth/0	<javax.swing.text.Utilities: int getTabbedTextWidth(javax.swing.text.View,javax.swing.text.Segment,java.awt.FontMetrics,int,javax.swing.text.TabExpander,int,int[])>
<javax.swing.text.GlyphPainter1: void paint(javax.swing.text.GlyphView,java.awt.Graphics,java.awt.Shape,int,int)>/java.awt.FontMetrics.getDescent/0	<sun.font.FontDesignMetrics: int getDescent()>
<javax.swing.text.GlyphPainter1: void paint(javax.swing.text.GlyphView,java.awt.Graphics,java.awt.Shape,int,int)>/java.awt.FontMetrics.getFont/0	<java.awt.FontMetrics: java.awt.Font getFont()>
<javax.swing.text.GlyphPainter1: void paint(javax.swing.text.GlyphView,java.awt.Graphics,java.awt.Shape,int,int)>/java.awt.FontMetrics.getHeight/0	<sun.font.FontDesignMetrics: int getHeight()>
<javax.swing.text.GlyphPainter1: void paint(javax.swing.text.GlyphView,java.awt.Graphics,java.awt.Shape,int,int)>/java.awt.Graphics.setFont/0	<sun.java2d.SunGraphics2D: void setFont(java.awt.Font)>
<javax.swing.text.GlyphPainter1: void paint(javax.swing.text.GlyphView,java.awt.Graphics,java.awt.Shape,int,int)>/javax.swing.text.GlyphPainter1.getJustificationData/0	<javax.swing.text.GlyphPainter1: int[] getJustificationData(javax.swing.text.GlyphView)>
<javax.swing.text.GlyphPainter1: void paint(javax.swing.text.GlyphView,java.awt.Graphics,java.awt.Shape,int,int)>/javax.swing.text.GlyphPainter1.sync/0	<javax.swing.text.GlyphPainter1: void sync(javax.swing.text.GlyphView)>
<javax.swing.text.GlyphPainter1: void paint(javax.swing.text.GlyphView,java.awt.Graphics,java.awt.Shape,int,int)>/javax.swing.text.GlyphView.getStartOffset/0	<javax.swing.text.GlyphView: int getStartOffset()>
<javax.swing.text.GlyphPainter1: void paint(javax.swing.text.GlyphView,java.awt.Graphics,java.awt.Shape,int,int)>/javax.swing.text.GlyphView.getTabExpander/0	<javax.swing.text.GlyphView: javax.swing.text.TabExpander getTabExpander()>
<javax.swing.text.GlyphPainter1: void paint(javax.swing.text.GlyphView,java.awt.Graphics,java.awt.Shape,int,int)>/javax.swing.text.GlyphView.getText/1	<javax.swing.text.GlyphView: javax.swing.text.Segment getText(int,int)>
<javax.swing.text.GlyphPainter1: void paint(javax.swing.text.GlyphView,java.awt.Graphics,java.awt.Shape,int,int)>/javax.swing.text.SegmentCache.releaseSharedSegment/1	<javax.swing.text.SegmentCache: void releaseSharedSegment(javax.swing.text.Segment)>
<javax.swing.text.GlyphPainter1: void paint(javax.swing.text.GlyphView,java.awt.Graphics,java.awt.Shape,int,int)>/javax.swing.text.Utilities.drawTabbedText/0	<javax.swing.text.Utilities: int drawTabbedText(javax.swing.text.View,javax.swing.text.Segment,int,int,java.awt.Graphics,javax.swing.text.TabExpander,int,int[])>
<javax.swing.text.GlyphView$GlyphPainter: int getNextVisualPositionFrom(javax.swing.text.GlyphView,int,javax.swing.text.Position$Bias,java.awt.Shape,int,javax.swing.text.Position$Bias[])>/javax.swing.text.Document.getLength/0	<javax.swing.text.AbstractDocument: int getLength()>
<javax.swing.text.GlyphView$GlyphPainter: int getNextVisualPositionFrom(javax.swing.text.GlyphView,int,javax.swing.text.Position$Bias,java.awt.Shape,int,javax.swing.text.Position$Bias[])>/javax.swing.text.GlyphView.getDocument/0	<javax.swing.text.View: javax.swing.text.Document getDocument()>
<javax.swing.text.GlyphView$GlyphPainter: int getNextVisualPositionFrom(javax.swing.text.GlyphView,int,javax.swing.text.Position$Bias,java.awt.Shape,int,javax.swing.text.Position$Bias[])>/javax.swing.text.GlyphView.getEndOffset/0	<javax.swing.text.GlyphView: int getEndOffset()>
<javax.swing.text.GlyphView$GlyphPainter: int getNextVisualPositionFrom(javax.swing.text.GlyphView,int,javax.swing.text.Position$Bias,java.awt.Shape,int,javax.swing.text.Position$Bias[])>/javax.swing.text.GlyphView.getStartOffset/0	<javax.swing.text.GlyphView: int getStartOffset()>
<javax.swing.text.GlyphView: int getNextVisualPositionFrom(int,javax.swing.text.Position$Bias,java.awt.Shape,int,javax.swing.text.Position$Bias[])>/javax.swing.text.GlyphView$GlyphPainter.getNextVisualPositionFrom/0	<javax.swing.text.GlyphView$GlyphPainter: int getNextVisualPositionFrom(javax.swing.text.GlyphView,int,javax.swing.text.Position$Bias,java.awt.Shape,int,javax.swing.text.Position$Bias[])>
<javax.swing.text.GlyphView: int viewToModel(float,float,java.awt.Shape,javax.swing.text.Position$Bias[])>/javax.swing.text.GlyphView$GlyphPainter.viewToModel/0	<javax.swing.text.GlyphPainter1: int viewToModel(javax.swing.text.GlyphView,float,float,java.awt.Shape,javax.swing.text.Position$Bias[])>
<javax.swing.text.GlyphView: java.awt.Shape modelToView(int,java.awt.Shape,javax.swing.text.Position$Bias)>/javax.swing.text.GlyphView$GlyphPainter.modelToView/0	<javax.swing.text.GlyphPainter1: java.awt.Shape modelToView(javax.swing.text.GlyphView,int,javax.swing.text.Position$Bias,java.awt.Shape)>
<javax.swing.text.GlyphView: javax.swing.text.View breakView(int,int,float,float)>/javax.swing.text.GlyphView$GlyphPainter.getBoundedPosition/0	<javax.swing.text.GlyphPainter1: int getBoundedPosition(javax.swing.text.GlyphView,int,float,float)>
<javax.swing.text.GlyphView: javax.swing.text.View createFragment(int,int)>/javax.swing.text.GlyphView$GlyphPainter.getPainter/0	<javax.swing.text.GlyphView$GlyphPainter: javax.swing.text.GlyphView$GlyphPainter getPainter(javax.swing.text.GlyphView,int,int)>
<javax.swing.text.GlyphView: void paintTextUsingColor(java.awt.Graphics,java.awt.Shape,java.awt.Color,int,int)>/javax.swing.text.GlyphView$GlyphPainter.paint/0	<javax.swing.text.GlyphPainter1: void paint(javax.swing.text.GlyphView,java.awt.Graphics,java.awt.Shape,int,int)>
<javax.swing.text.Utilities: int getTabbedTextOffset(javax.swing.text.View,javax.swing.text.Segment,java.awt.FontMetrics,int,int,javax.swing.text.TabExpander,int,int[])>/javax.swing.text.Utilities.getTabbedTextOffset/0	<javax.swing.text.Utilities: int getTabbedTextOffset(javax.swing.text.View,javax.swing.text.Segment,java.awt.FontMetrics,int,int,javax.swing.text.TabExpander,int,boolean,int[])>
<javax.swing.text.WrappedPlainView: void <init>(javax.swing.text.Element)>/javax.swing.text.WrappedPlainView.<init>/0	<javax.swing.text.WrappedPlainView: void <init>(javax.swing.text.Element,boolean)>
<javax.swing.text.html.parser.ContentModel: boolean first(java.lang.Object)>/javax.swing.text.html.parser.ContentModel.empty/0	<javax.swing.text.html.parser.ContentModel: boolean empty()>
<javax.swing.text.html.parser.ContentModel: boolean first(java.lang.Object)>/javax.swing.text.html.parser.ContentModel.first/0	<javax.swing.text.html.parser.ContentModel: boolean first(java.lang.Object)>
<javax.swing.text.html.parser.ContentModel: boolean first(java.lang.Object)>/javax.swing.text.html.parser.ContentModel.first/1	<javax.swing.text.html.parser.ContentModel: boolean first(java.lang.Object)>
<javax.swing.text.html.parser.ContentModel: boolean first(java.lang.Object)>/javax.swing.text.html.parser.ContentModel.first/2	<javax.swing.text.html.parser.ContentModel: boolean first(java.lang.Object)>
<javax.swing.text.html.parser.ContentModel: void getElements(java.util.Vector)>/java.util.Vector.addElement/0	<java.util.Vector: void addElement(java.lang.Object)>
<javax.swing.text.html.parser.ContentModel: void getElements(java.util.Vector)>/javax.swing.text.html.parser.ContentModel.getElements/0	<javax.swing.text.html.parser.ContentModel: void getElements(java.util.Vector)>
<javax.swing.text.html.parser.ContentModel: void getElements(java.util.Vector)>/javax.swing.text.html.parser.ContentModel.getElements/1	<javax.swing.text.html.parser.ContentModel: void getElements(java.util.Vector)>
<javax.swing.text.html.parser.ContentModelState: boolean terminate()>/javax.swing.text.html.parser.ContentModel.empty/2	<javax.swing.text.html.parser.ContentModel: boolean empty()>
<javax.swing.text.html.parser.ContentModelState: boolean terminate()>/javax.swing.text.html.parser.ContentModel.empty/3	<javax.swing.text.html.parser.ContentModel: boolean empty()>
<javax.swing.text.html.parser.ContentModelState: javax.swing.text.html.parser.ContentModelState advance(java.lang.Object)>/javax.swing.text.html.parser.ContentModel.empty/0	<javax.swing.text.html.parser.ContentModel: boolean empty()>
<javax.swing.text.html.parser.ContentModelState: javax.swing.text.html.parser.ContentModelState advance(java.lang.Object)>/javax.swing.text.html.parser.ContentModel.empty/1	<javax.swing.text.html.parser.ContentModel: boolean empty()>
<javax.swing.text.html.parser.ContentModelState: javax.swing.text.html.parser.ContentModelState advance(java.lang.Object)>/javax.swing.text.html.parser.ContentModel.first/1	<javax.swing.text.html.parser.ContentModel: boolean first(java.lang.Object)>
<javax.swing.text.html.parser.ContentModelState: javax.swing.text.html.parser.ContentModelState advance(java.lang.Object)>/javax.swing.text.html.parser.ContentModel.first/3	<javax.swing.text.html.parser.ContentModel: boolean first(java.lang.Object)>
<javax.swing.text.html.parser.ContentModelState: javax.swing.text.html.parser.ContentModelState advance(java.lang.Object)>/javax.swing.text.html.parser.ContentModel.first/4	<javax.swing.text.html.parser.ContentModel: boolean first(java.lang.Object)>
<javax.swing.text.html.parser.ContentModelState: javax.swing.text.html.parser.ContentModelState advance(java.lang.Object)>/javax.swing.text.html.parser.ContentModel.first/5	<javax.swing.text.html.parser.ContentModel: boolean first(java.lang.Object)>
<javax.swing.text.html.parser.ContentModelState: javax.swing.text.html.parser.Element first()>/javax.swing.text.html.parser.ContentModel.first/1	<javax.swing.text.html.parser.ContentModel: javax.swing.text.html.parser.Element first()>
<javax.swing.text.html.parser.DTD: boolean elementExists(java.lang.String)>/java.util.Hashtable.get/0	<java.util.Hashtable: java.lang.Object get(java.lang.Object)>
<javax.swing.text.html.parser.DTD: javax.swing.text.html.parser.Entity getEntity(java.lang.String)>/java.util.Hashtable.get/0	<java.util.Hashtable: java.lang.Object get(java.lang.Object)>
<javax.swing.text.html.parser.Parser: boolean ignoreElement(javax.swing.text.html.parser.Element)>/javax.swing.text.html.parser.Element.getName/0	<javax.swing.text.html.parser.Element: java.lang.String getName()>
<javax.swing.text.html.parser.Parser: boolean ignoreElement(javax.swing.text.html.parser.Element)>/javax.swing.text.html.parser.Element.getName/1	<javax.swing.text.html.parser.Element: java.lang.String getName()>
<javax.swing.text.html.parser.Parser: boolean legalElementContext(javax.swing.text.html.parser.Element)>/javax.swing.text.html.parser.ContentModel.first/0	<javax.swing.text.html.parser.ContentModel: boolean first(java.lang.Object)>
<javax.swing.text.html.parser.Parser: boolean legalElementContext(javax.swing.text.html.parser.Element)>/javax.swing.text.html.parser.ContentModel.getElements/0	<javax.swing.text.html.parser.ContentModel: void getElements(java.util.Vector)>
<javax.swing.text.html.parser.Parser: boolean legalElementContext(javax.swing.text.html.parser.Element)>/javax.swing.text.html.parser.Element.getAttributes/0	<javax.swing.text.html.parser.Element: javax.swing.text.html.parser.AttributeList getAttributes()>
<javax.swing.text.html.parser.Parser: boolean legalElementContext(javax.swing.text.html.parser.Element)>/javax.swing.text.html.parser.Element.getContent/0	<javax.swing.text.html.parser.Element: javax.swing.text.html.parser.ContentModel getContent()>
<javax.swing.text.html.parser.Parser: boolean legalElementContext(javax.swing.text.html.parser.Element)>/javax.swing.text.html.parser.Element.getIndex/0	<javax.swing.text.html.parser.Element: int getIndex()>
<javax.swing.text.html.parser.Parser: boolean legalElementContext(javax.swing.text.html.parser.Element)>/javax.swing.text.html.parser.Element.getName/0	<javax.swing.text.html.parser.Element: java.lang.String getName()>
<javax.swing.text.html.parser.Parser: boolean legalElementContext(javax.swing.text.html.parser.Element)>/javax.swing.text.html.parser.Element.getName/1	<javax.swing.text.html.parser.Element: java.lang.String getName()>
<javax.swing.text.html.parser.Parser: boolean legalElementContext(javax.swing.text.html.parser.Element)>/javax.swing.text.html.parser.Element.getName/2	<javax.swing.text.html.parser.Element: java.lang.String getName()>
<javax.swing.text.html.parser.Parser: boolean legalElementContext(javax.swing.text.html.parser.Element)>/javax.swing.text.html.parser.Element.getName/3	<javax.swing.text.html.parser.Element: java.lang.String getName()>
<javax.swing.text.html.parser.Parser: boolean legalElementContext(javax.swing.text.html.parser.Element)>/javax.swing.text.html.parser.Element.getName/8	<javax.swing.text.html.parser.Element: java.lang.String getName()>
<javax.swing.text.html.parser.Parser: boolean legalElementContext(javax.swing.text.html.parser.Element)>/javax.swing.text.html.parser.Element.omitEnd/3	<javax.swing.text.html.parser.Element: boolean omitEnd()>
<javax.swing.text.html.parser.Parser: boolean legalElementContext(javax.swing.text.html.parser.Element)>/javax.swing.text.html.parser.Element.omitStart/1	<javax.swing.text.html.parser.Element: boolean omitStart()>
<javax.swing.text.html.parser.Parser: char[] parseEntityReference()>/javax.swing.text.html.parser.DTD.getEntity/0	<javax.swing.text.html.parser.DTD: javax.swing.text.html.parser.Entity getEntity(java.lang.String)>
<javax.swing.text.html.parser.Parser: char[] parseEntityReference()>/javax.swing.text.html.parser.Entity.getData/0	<javax.swing.text.html.parser.Entity: char[] getData()>
<javax.swing.text.html.parser.Parser: char[] parseEntityReference()>/javax.swing.text.html.parser.Entity.isGeneral/0	<javax.swing.text.html.parser.Entity: boolean isGeneral()>
<javax.swing.text.html.parser.Parser: void endTag(boolean)>/javax.swing.text.html.parser.Element.omitEnd/0	<javax.swing.text.html.parser.Element: boolean omitEnd()>
<javax.swing.text.html.parser.Parser: void handleText(javax.swing.text.html.parser.TagElement)>/javax.swing.text.html.parser.Element.getName/0	<javax.swing.text.html.parser.Element: java.lang.String getName()>
<javax.swing.text.html.parser.Parser: void handleText(javax.swing.text.html.parser.TagElement)>/javax.swing.text.html.parser.Element.isEmpty/0	<javax.swing.text.html.parser.Element: boolean isEmpty()>
<javax.swing.text.html.parser.Parser: void markFirstTime(javax.swing.text.html.parser.Element)>/javax.swing.text.html.parser.Element.getName/0	<javax.swing.text.html.parser.Element: java.lang.String getName()>
<javax.swing.text.html.parser.Parser: void parseAttributeSpecificationList(javax.swing.text.html.parser.Element)>/javax.swing.text.html.parser.Element.getAttribute/0	<javax.swing.text.html.parser.Element: javax.swing.text.html.parser.AttributeList getAttribute(java.lang.String)>
<javax.swing.text.html.parser.Parser: void parseAttributeSpecificationList(javax.swing.text.html.parser.Element)>/javax.swing.text.html.parser.Element.getName/4	<javax.swing.text.html.parser.Element: java.lang.String getName()>
<javax.swing.text.html.parser.Parser: void parseTag()>/javax.swing.text.html.parser.DTD.elementExists/0	<javax.swing.text.html.parser.DTD: boolean elementExists(java.lang.String)>
<javax.swing.text.html.parser.Parser: void parseTag()>/javax.swing.text.html.parser.DTD.elementExists/1	<javax.swing.text.html.parser.DTD: boolean elementExists(java.lang.String)>
<javax.swing.text.html.parser.Parser: void parseTag()>/javax.swing.text.html.parser.DTD.getElement/2	<javax.swing.text.html.parser.DTD: javax.swing.text.html.parser.Element getElement(java.lang.String)>
<javax.swing.text.html.parser.Parser: void parseTag()>/javax.swing.text.html.parser.DTD.getElement/4	<javax.swing.text.html.parser.DTD: javax.swing.text.html.parser.Element getElement(java.lang.String)>
<javax.swing.text.html.parser.Parser: void parseTag()>/javax.swing.text.html.parser.Element.getName/1	<javax.swing.text.html.parser.Element: java.lang.String getName()>
<javax.swing.text.html.parser.Parser: void parseTag()>/javax.swing.text.html.parser.Element.getName/7	<javax.swing.text.html.parser.Element: java.lang.String getName()>
<javax.swing.text.html.parser.Parser: void parseTag()>/javax.swing.text.html.parser.Element.getName/8	<javax.swing.text.html.parser.Element: java.lang.String getName()>
<javax.swing.text.html.parser.Parser: void parseTag()>/javax.swing.text.html.parser.Element.getName/9	<javax.swing.text.html.parser.Element: java.lang.String getName()>
<javax.swing.text.html.parser.Parser: void parseTag()>/javax.swing.text.html.parser.Element.getType/0	<javax.swing.text.html.parser.Element: int getType()>
<javax.swing.text.html.parser.Parser: void parseTag()>/javax.swing.text.html.parser.Element.isEmpty/0	<javax.swing.text.html.parser.Element: boolean isEmpty()>
<javax.swing.text.html.parser.Parser: void parseTag()>/javax.swing.text.html.parser.Element.isEmpty/1	<javax.swing.text.html.parser.Element: boolean isEmpty()>
<javax.swing.text.html.parser.Parser: void startTag(javax.swing.text.html.parser.TagElement)>/javax.swing.text.html.parser.Element.isEmpty/0	<javax.swing.text.html.parser.Element: boolean isEmpty()>
<javax.swing.text.html.parser.Parser: void startTag(javax.swing.text.html.parser.TagElement)>/javax.swing.text.html.parser.Element.isEmpty/1	<javax.swing.text.html.parser.Element: boolean isEmpty()>
<javax.swing.text.html.parser.TagElement: void <init>(javax.swing.text.html.parser.Element,boolean)>/javax.swing.text.html.parser.Element.getName/0	<javax.swing.text.html.parser.Element: java.lang.String getName()>
<javax.swing.text.html.parser.TagStack: boolean advance(javax.swing.text.html.parser.Element)>/java.util.BitSet.get/1	<java.util.BitSet: boolean get(int)>
<javax.swing.text.html.parser.TagStack: boolean advance(javax.swing.text.html.parser.Element)>/javax.swing.text.html.parser.Element.getIndex/1	<javax.swing.text.html.parser.Element: int getIndex()>
<javax.swing.text.html.parser.TagStack: void <init>(javax.swing.text.html.parser.TagElement,javax.swing.text.html.parser.TagStack)>/javax.swing.text.html.parser.Element.getContent/0	<javax.swing.text.html.parser.Element: javax.swing.text.html.parser.ContentModel getContent()>
<javax.swing.text.html.parser.TagStack: void <init>(javax.swing.text.html.parser.TagElement,javax.swing.text.html.parser.TagStack)>/javax.swing.text.html.parser.Element.getContent/1	<javax.swing.text.html.parser.Element: javax.swing.text.html.parser.ContentModel getContent()>
<org.jpedal.fonts.tt.TTGlyph: void render(int,java.awt.Graphics2D,float,boolean)>/java.awt.BasicStroke.<init>/0	<java.awt.BasicStroke: void <init>(float,int,int,float,float[],float)>
<org.jpedal.fonts.tt.TTGlyph: void render(int,java.awt.Graphics2D,float,boolean)>/java.awt.BasicStroke.getDashArray/0	<java.awt.BasicStroke: float[] getDashArray()>
<org.jpedal.fonts.tt.TTGlyph: void render(int,java.awt.Graphics2D,float,boolean)>/java.awt.BasicStroke.getDashPhase/0	<java.awt.BasicStroke: float getDashPhase()>
<org.jpedal.fonts.tt.TTGlyph: void render(int,java.awt.Graphics2D,float,boolean)>/java.awt.BasicStroke.getLineWidth/0	<java.awt.BasicStroke: float getLineWidth()>
<org.jpedal.fonts.tt.TTGlyph: void render(int,java.awt.Graphics2D,float,boolean)>/java.awt.BasicStroke.getMiterLimit/0	<java.awt.BasicStroke: float getMiterLimit()>
<org.jpedal.fonts.tt.TTGlyph: void render(int,java.awt.Graphics2D,float,boolean)>/java.awt.Graphics2D.fill/0	<sun.java2d.SunGraphics2D: void fill(java.awt.Shape)>
<org.jpedal.fonts.tt.TTGlyph: void render(int,java.awt.Graphics2D,float,boolean)>/java.awt.Graphics2D.getStroke/0	<sun.java2d.SunGraphics2D: java.awt.Stroke getStroke()>
<org.jpedal.fonts.tt.TTGlyph: void render(int,java.awt.Graphics2D,float,boolean)>/java.awt.Graphics2D.getTransform/0	<sun.java2d.SunGraphics2D: java.awt.geom.AffineTransform getTransform()>
<org.jpedal.fonts.tt.TTGlyph: void render(int,java.awt.Graphics2D,float,boolean)>/java.awt.Graphics2D.setStroke/0	<sun.java2d.SunGraphics2D: void setStroke(java.awt.Stroke)>
<org.jpedal.fonts.tt.TTGlyph: void render(int,java.awt.Graphics2D,float,boolean)>/org.jpedal.utils.repositories.Vector_Path.elementAt/0	<org.jpedal.utils.repositories.Vector_Path: java.awt.geom.GeneralPath elementAt(int)>
<org.jpedal.fonts.tt.TTGlyph: void render(int,java.awt.Graphics2D,float,boolean)>/org.jpedal.utils.repositories.Vector_Path.size/0	<org.jpedal.utils.repositories.Vector_Path: int size()>
<org.jpedal.render.BaseDisplay: void renderEmbeddedText(int,java.lang.Object,int,java.awt.geom.AffineTransform,java.awt.Rectangle,org.jpedal.color.PdfPaint,org.jpedal.color.PdfPaint,float,float,int)>/org.jpedal.fonts.glyph.PdfGlyph.render/0	<org.jpedal.fonts.tt.TTGlyph: void render(int,java.awt.Graphics2D,float,boolean)>
<sun.security.pkcs.SignerInfo: java.util.ArrayList getCertificateChain(sun.security.pkcs.PKCS7)>/java.lang.Object.equals/0	<sun.security.x509.X500Name: boolean equals(java.lang.Object)>
<sun.security.pkcs.SignerInfo: java.util.ArrayList getCertificateChain(sun.security.pkcs.PKCS7)>/java.security.cert.X509Certificate.getIssuerDN/0	<sun.security.x509.X509CertImpl: java.security.Principal getIssuerDN()>
<sun.security.pkcs.SignerInfo: java.util.ArrayList getCertificateChain(sun.security.pkcs.PKCS7)>/java.security.cert.X509Certificate.getSubjectDN/0	<sun.security.x509.X509CertImpl: java.security.Principal getSubjectDN()>
<sun.security.pkcs.SignerInfo: java.util.ArrayList getCertificateChain(sun.security.pkcs.PKCS7)>/java.util.ArrayList.<init>/0	<java.util.ArrayList: void <init>()>
<sun.security.pkcs.SignerInfo: java.util.ArrayList getCertificateChain(sun.security.pkcs.PKCS7)>/java.util.ArrayList.add/0	<java.util.ArrayList: boolean add(java.lang.Object)>
<sun.security.pkcs.SignerInfo: java.util.ArrayList getCertificateChain(sun.security.pkcs.PKCS7)>/sun.security.pkcs.PKCS7.getCertificate/0	<sun.security.pkcs.PKCS7: java.security.cert.X509Certificate getCertificate(java.math.BigInteger,sun.security.x509.X500Name)>
<sun.security.pkcs.SignerInfo: java.util.ArrayList getCertificateChain(sun.security.pkcs.PKCS7)>/sun.security.pkcs.PKCS7.getCertificates/0	<sun.security.pkcs.PKCS7: java.security.cert.X509Certificate[] getCertificates()>
<sun.security.util.SignatureFileVerifier: java.security.CodeSigner[] getSigners(sun.security.pkcs.SignerInfo[],sun.security.pkcs.PKCS7)>/sun.security.pkcs.SignerInfo.getCertificateChain/0	<sun.security.pkcs.SignerInfo: java.util.ArrayList getCertificateChain(sun.security.pkcs.PKCS7)>
<sun.security.util.SignatureFileVerifier: java.security.Timestamp getTimestamp(sun.security.pkcs.SignerInfo)>/sun.security.pkcs.SignerInfo.getUnauthenticatedAttributes/0	<sun.security.pkcs.SignerInfo: sun.security.pkcs.PKCS9Attributes getUnauthenticatedAttributes()>
<sun.nio.cs.StreamDecoder: int implRead(char[],int,int)>/java.nio.charset.CharsetDecoder.decode/0	<java.nio.charset.CharsetDecoder: java.nio.charset.CoderResult decode(java.nio.ByteBuffer,java.nio.CharBuffer,boolean)>
<sun.nio.cs.StreamDecoder: int implRead(char[],int,int)>/java.nio.charset.CharsetDecoder.reset/1	<java.nio.charset.CharsetDecoder: java.nio.charset.CharsetDecoder reset()>
<sun.nio.cs.StreamDecoder: int implRead(char[],int,int)>/java.nio.charset.CoderResult.isUnderflow/0	<java.nio.charset.CoderResult: boolean isUnderflow()>
<sun.nio.cs.StreamDecoder: void <init>(java.io.InputStream,java.lang.Object,java.nio.charset.Charset)>/java.nio.charset.CharsetDecoder.onUnmappableCharacter/0	<java.nio.charset.CharsetDecoder: java.nio.charset.CharsetDecoder onUnmappableCharacter(java.nio.charset.CodingErrorAction)>
<sun.nio.cs.StreamDecoder: void <init>(java.io.InputStream,java.lang.Object,java.nio.charset.CharsetDecoder)>/java.nio.charset.CharsetDecoder.charset/0	<java.nio.charset.CharsetDecoder: java.nio.charset.Charset charset()>
<sun.nio.cs.StreamEncoder: void <init>(java.io.OutputStream,java.lang.Object,java.nio.charset.Charset)>/java.nio.charset.CharsetEncoder.onUnmappableCharacter/0	<java.nio.charset.CharsetEncoder: java.nio.charset.CharsetEncoder onUnmappableCharacter(java.nio.charset.CodingErrorAction)>
<sun.nio.cs.StreamEncoder: void <init>(java.io.OutputStream,java.lang.Object,java.nio.charset.CharsetEncoder)>/java.nio.charset.CharsetEncoder.charset/0	<java.nio.charset.CharsetEncoder: java.nio.charset.Charset charset()>
<sun.nio.cs.StreamEncoder: void implWrite(char[],int,int)>/java.nio.charset.CharsetEncoder.encode/0	<java.nio.charset.CharsetEncoder: java.nio.charset.CoderResult encode(java.nio.CharBuffer,java.nio.ByteBuffer,boolean)>
<sun.nio.cs.StreamEncoder: void implWrite(char[],int,int)>/java.nio.charset.CoderResult.isUnderflow/0	<java.nio.charset.CoderResult: boolean isUnderflow()>
<java.awt.ImageMediaEntry: int getStatus(boolean,boolean)>/java.awt.ImageMediaEntry.setStatus/0	<java.awt.MediaEntry: void setStatus(int)>
<java.lang.ProcessBuilder: java.lang.Process start()>/java.io.File.toString/0	<java.io.File: java.lang.String toString()>
<javax.swing.plaf.basic.BasicButtonListener: javax.swing.InputMap getInputMap(int,javax.swing.JComponent)>/javax.swing.plaf.basic.BasicButtonUI.getPropertyPrefix/0	<javax.swing.plaf.metal.MetalCheckBoxUI: java.lang.String getPropertyPrefix()>
<javax.swing.plaf.basic.BasicButtonListener: void focusLost(java.awt.event.FocusEvent)>/javax.swing.plaf.basic.BasicButtonUI.getPropertyPrefix/0	<javax.swing.plaf.metal.MetalCheckBoxUI: java.lang.String getPropertyPrefix()>
<javax.swing.text.GlyphView$GlyphPainter: int getNextVisualPositionFrom(javax.swing.text.GlyphView,int,javax.swing.text.Position$Bias,java.awt.Shape,int,javax.swing.text.Position$Bias[])>/javax.swing.text.Document.getLength/1	<javax.swing.text.AbstractDocument: int getLength()>
<javax.swing.text.GlyphView$GlyphPainter: int getNextVisualPositionFrom(javax.swing.text.GlyphView,int,javax.swing.text.Position$Bias,java.awt.Shape,int,javax.swing.text.Position$Bias[])>/javax.swing.text.GlyphView.getDocument/1	<javax.swing.text.View: javax.swing.text.Document getDocument()>
<javax.swing.text.html.parser.ContentModelState: javax.swing.text.html.parser.ContentModelState advance(java.lang.Object)>/javax.swing.text.html.parser.ContentModel.first/2	<javax.swing.text.html.parser.ContentModel: boolean first(java.lang.Object)>
<javax.swing.text.html.parser.TagStack: boolean advance(javax.swing.text.html.parser.Element)>/java.util.BitSet.get/0	<java.util.BitSet: boolean get(int)>
<javax.swing.text.html.parser.TagStack: boolean advance(javax.swing.text.html.parser.Element)>/javax.swing.text.html.parser.Element.getIndex/0	<javax.swing.text.html.parser.Element: int getIndex()>
<soot.coffi.CFG: soot.coffi.OutFlow processFlow(soot.coffi.Instruction,soot.coffi.TypeStack,soot.coffi.cp_info[])>/java.lang.Object.equals/0	<soot.ArrayType: boolean equals(java.lang.Object)>
<soot.coffi.CFG: soot.coffi.OutFlow processFlow(soot.coffi.Instruction,soot.coffi.TypeStack,soot.coffi.cp_info[])>/java.lang.Object.equals/0	<soot.DoubleType: boolean equals(java.lang.Object)>
<soot.coffi.CFG: soot.coffi.OutFlow processFlow(soot.coffi.Instruction,soot.coffi.TypeStack,soot.coffi.cp_info[])>/java.lang.Object.equals/0	<soot.FloatType: boolean equals(java.lang.Object)>
<soot.coffi.CFG: soot.coffi.OutFlow processFlow(soot.coffi.Instruction,soot.coffi.TypeStack,soot.coffi.cp_info[])>/java.lang.Object.equals/0	<soot.LongType: boolean equals(java.lang.Object)>
<soot.coffi.CFG: soot.coffi.OutFlow processFlow(soot.coffi.Instruction,soot.coffi.TypeStack,soot.coffi.cp_info[])>/java.lang.Object.equals/0	<soot.RefType: boolean equals(java.lang.Object)>
<soot.coffi.CFG: soot.coffi.OutFlow processFlow(soot.coffi.Instruction,soot.coffi.TypeStack,soot.coffi.cp_info[])>/java.lang.Object.equals/1	<soot.ArrayType: boolean equals(java.lang.Object)>
<soot.coffi.CFG: soot.coffi.OutFlow processFlow(soot.coffi.Instruction,soot.coffi.TypeStack,soot.coffi.cp_info[])>/java.lang.Object.equals/1	<soot.FloatType: boolean equals(java.lang.Object)>
<soot.coffi.CFG: soot.coffi.OutFlow processFlow(soot.coffi.Instruction,soot.coffi.TypeStack,soot.coffi.cp_info[])>/java.lang.Object.equals/1	<soot.LongType: boolean equals(java.lang.Object)>
<soot.coffi.CFG: soot.coffi.OutFlow processFlow(soot.coffi.Instruction,soot.coffi.TypeStack,soot.coffi.cp_info[])>/java.lang.Object.equals/1	<soot.RefType: boolean equals(java.lang.Object)>
<soot.coffi.CFG: soot.coffi.OutFlow processFlow(soot.coffi.Instruction,soot.coffi.TypeStack,soot.coffi.cp_info[])>/java.lang.Object.equals/10	<soot.ArrayType: boolean equals(java.lang.Object)>
<soot.coffi.CFG: soot.coffi.OutFlow processFlow(soot.coffi.Instruction,soot.coffi.TypeStack,soot.coffi.cp_info[])>/java.lang.Object.equals/10	<soot.DoubleType: boolean equals(java.lang.Object)>
<soot.coffi.CFG: soot.coffi.OutFlow processFlow(soot.coffi.Instruction,soot.coffi.TypeStack,soot.coffi.cp_info[])>/java.lang.Object.equals/10	<soot.FloatType: boolean equals(java.lang.Object)>
<soot.coffi.CFG: soot.coffi.OutFlow processFlow(soot.coffi.Instruction,soot.coffi.TypeStack,soot.coffi.cp_info[])>/java.lang.Object.equals/10	<soot.LongType: boolean equals(java.lang.Object)>
<soot.coffi.CFG: soot.coffi.OutFlow processFlow(soot.coffi.Instruction,soot.coffi.TypeStack,soot.coffi.cp_info[])>/java.lang.Object.equals/10	<soot.RefType: boolean equals(java.lang.Object)>
<soot.coffi.CFG: soot.coffi.OutFlow processFlow(soot.coffi.Instruction,soot.coffi.TypeStack,soot.coffi.cp_info[])>/java.lang.Object.equals/10	<soot.VoidType: boolean equals(java.lang.Object)>
<soot.coffi.CFG: soot.coffi.OutFlow processFlow(soot.coffi.Instruction,soot.coffi.TypeStack,soot.coffi.cp_info[])>/java.lang.Object.equals/13	<soot.ArrayType: boolean equals(java.lang.Object)>
<soot.coffi.CFG: soot.coffi.OutFlow processFlow(soot.coffi.Instruction,soot.coffi.TypeStack,soot.coffi.cp_info[])>/java.lang.Object.equals/13	<soot.LongType: boolean equals(java.lang.Object)>
<soot.coffi.CFG: soot.coffi.OutFlow processFlow(soot.coffi.Instruction,soot.coffi.TypeStack,soot.coffi.cp_info[])>/java.lang.Object.equals/13	<soot.RefType: boolean equals(java.lang.Object)>
<soot.coffi.CFG: soot.coffi.OutFlow processFlow(soot.coffi.Instruction,soot.coffi.TypeStack,soot.coffi.cp_info[])>/java.lang.Object.equals/13	<soot.VoidType: boolean equals(java.lang.Object)>
<soot.coffi.CFG: soot.coffi.OutFlow processFlow(soot.coffi.Instruction,soot.coffi.TypeStack,soot.coffi.cp_info[])>/java.lang.Object.equals/16	<soot.ArrayType: boolean equals(java.lang.Object)>
<soot.coffi.CFG: soot.coffi.OutFlow processFlow(soot.coffi.Instruction,soot.coffi.TypeStack,soot.coffi.cp_info[])>/java.lang.Object.equals/16	<soot.DoubleType: boolean equals(java.lang.Object)>
<soot.coffi.CFG: soot.coffi.OutFlow processFlow(soot.coffi.Instruction,soot.coffi.TypeStack,soot.coffi.cp_info[])>/java.lang.Object.equals/16	<soot.FloatType: boolean equals(java.lang.Object)>
<soot.coffi.CFG: soot.coffi.OutFlow processFlow(soot.coffi.Instruction,soot.coffi.TypeStack,soot.coffi.cp_info[])>/java.lang.Object.equals/16	<soot.LongType: boolean equals(java.lang.Object)>
<soot.coffi.CFG: soot.coffi.OutFlow processFlow(soot.coffi.Instruction,soot.coffi.TypeStack,soot.coffi.cp_info[])>/java.lang.Object.equals/16	<soot.RefType: boolean equals(java.lang.Object)>
<soot.coffi.CFG: soot.coffi.OutFlow processFlow(soot.coffi.Instruction,soot.coffi.TypeStack,soot.coffi.cp_info[])>/java.lang.Object.equals/16	<soot.VoidType: boolean equals(java.lang.Object)>
<soot.coffi.CFG: soot.coffi.OutFlow processFlow(soot.coffi.Instruction,soot.coffi.TypeStack,soot.coffi.cp_info[])>/java.lang.Object.equals/19	<soot.ArrayType: boolean equals(java.lang.Object)>
<soot.coffi.CFG: soot.coffi.OutFlow processFlow(soot.coffi.Instruction,soot.coffi.TypeStack,soot.coffi.cp_info[])>/java.lang.Object.equals/19	<soot.LongType: boolean equals(java.lang.Object)>
<soot.coffi.CFG: soot.coffi.OutFlow processFlow(soot.coffi.Instruction,soot.coffi.TypeStack,soot.coffi.cp_info[])>/java.lang.Object.equals/19	<soot.RefType: boolean equals(java.lang.Object)>
<soot.coffi.CFG: soot.coffi.OutFlow processFlow(soot.coffi.Instruction,soot.coffi.TypeStack,soot.coffi.cp_info[])>/java.lang.Object.equals/19	<soot.VoidType: boolean equals(java.lang.Object)>
<soot.coffi.CFG: soot.coffi.OutFlow processFlow(soot.coffi.Instruction,soot.coffi.TypeStack,soot.coffi.cp_info[])>/java.lang.Object.equals/2	<soot.ArrayType: boolean equals(java.lang.Object)>
<soot.coffi.CFG: soot.coffi.OutFlow processFlow(soot.coffi.Instruction,soot.coffi.TypeStack,soot.coffi.cp_info[])>/java.lang.Object.equals/2	<soot.DoubleType: boolean equals(java.lang.Object)>
<soot.coffi.CFG: soot.coffi.OutFlow processFlow(soot.coffi.Instruction,soot.coffi.TypeStack,soot.coffi.cp_info[])>/java.lang.Object.equals/2	<soot.FloatType: boolean equals(java.lang.Object)>
<soot.coffi.CFG: soot.coffi.OutFlow processFlow(soot.coffi.Instruction,soot.coffi.TypeStack,soot.coffi.cp_info[])>/java.lang.Object.equals/2	<soot.LongType: boolean equals(java.lang.Object)>
<soot.coffi.CFG: soot.coffi.OutFlow processFlow(soot.coffi.Instruction,soot.coffi.TypeStack,soot.coffi.cp_info[])>/java.lang.Object.equals/2	<soot.RefType: boolean equals(java.lang.Object)>
<soot.coffi.CFG: soot.coffi.OutFlow processFlow(soot.coffi.Instruction,soot.coffi.TypeStack,soot.coffi.cp_info[])>/java.lang.Object.equals/3	<soot.ArrayType: boolean equals(java.lang.Object)>
<soot.coffi.CFG: soot.coffi.OutFlow processFlow(soot.coffi.Instruction,soot.coffi.TypeStack,soot.coffi.cp_info[])>/java.lang.Object.equals/3	<soot.FloatType: boolean equals(java.lang.Object)>
<soot.coffi.CFG: soot.coffi.OutFlow processFlow(soot.coffi.Instruction,soot.coffi.TypeStack,soot.coffi.cp_info[])>/java.lang.Object.equals/3	<soot.LongType: boolean equals(java.lang.Object)>
<soot.coffi.CFG: soot.coffi.OutFlow processFlow(soot.coffi.Instruction,soot.coffi.TypeStack,soot.coffi.cp_info[])>/java.lang.Object.equals/3	<soot.RefType: boolean equals(java.lang.Object)>
<soot.coffi.CFG: soot.coffi.OutFlow processFlow(soot.coffi.Instruction,soot.coffi.TypeStack,soot.coffi.cp_info[])>/java.lang.Object.equals/4	<soot.ArrayType: boolean equals(java.lang.Object)>
<soot.coffi.CFG: soot.coffi.OutFlow processFlow(soot.coffi.Instruction,soot.coffi.TypeStack,soot.coffi.cp_info[])>/java.lang.Object.equals/4	<soot.DoubleType: boolean equals(java.lang.Object)>
<soot.coffi.CFG: soot.coffi.OutFlow processFlow(soot.coffi.Instruction,soot.coffi.TypeStack,soot.coffi.cp_info[])>/java.lang.Object.equals/4	<soot.LongType: boolean equals(java.lang.Object)>
<soot.coffi.CFG: soot.coffi.OutFlow processFlow(soot.coffi.Instruction,soot.coffi.TypeStack,soot.coffi.cp_info[])>/java.lang.Object.equals/4	<soot.RefType: boolean equals(java.lang.Object)>
<soot.coffi.CFG: soot.coffi.OutFlow processFlow(soot.coffi.Instruction,soot.coffi.TypeStack,soot.coffi.cp_info[])>/java.lang.Object.equals/5	<soot.ArrayType: boolean equals(java.lang.Object)>
<soot.coffi.CFG: soot.coffi.OutFlow processFlow(soot.coffi.Instruction,soot.coffi.TypeStack,soot.coffi.cp_info[])>/java.lang.Object.equals/5	<soot.LongType: boolean equals(java.lang.Object)>
<soot.coffi.CFG: soot.coffi.OutFlow processFlow(soot.coffi.Instruction,soot.coffi.TypeStack,soot.coffi.cp_info[])>/java.lang.Object.equals/5	<soot.RefType: boolean equals(java.lang.Object)>
<soot.coffi.CFG: soot.coffi.OutFlow processFlow(soot.coffi.Instruction,soot.coffi.TypeStack,soot.coffi.cp_info[])>/java.lang.Object.equals/6	<soot.ArrayType: boolean equals(java.lang.Object)>
<soot.coffi.CFG: soot.coffi.OutFlow processFlow(soot.coffi.Instruction,soot.coffi.TypeStack,soot.coffi.cp_info[])>/java.lang.Object.equals/6	<soot.DoubleType: boolean equals(java.lang.Object)>
<soot.coffi.CFG: soot.coffi.OutFlow processFlow(soot.coffi.Instruction,soot.coffi.TypeStack,soot.coffi.cp_info[])>/java.lang.Object.equals/6	<soot.LongType: boolean equals(java.lang.Object)>
<soot.coffi.CFG: soot.coffi.OutFlow processFlow(soot.coffi.Instruction,soot.coffi.TypeStack,soot.coffi.cp_info[])>/java.lang.Object.equals/6	<soot.RefType: boolean equals(java.lang.Object)>
<soot.coffi.CFG: soot.coffi.OutFlow processFlow(soot.coffi.Instruction,soot.coffi.TypeStack,soot.coffi.cp_info[])>/java.lang.Object.equals/7	<soot.ArrayType: boolean equals(java.lang.Object)>
<soot.coffi.CFG: soot.coffi.OutFlow processFlow(soot.coffi.Instruction,soot.coffi.TypeStack,soot.coffi.cp_info[])>/java.lang.Object.equals/7	<soot.LongType: boolean equals(java.lang.Object)>
<soot.coffi.CFG: soot.coffi.OutFlow processFlow(soot.coffi.Instruction,soot.coffi.TypeStack,soot.coffi.cp_info[])>/java.lang.Object.equals/7	<soot.RefType: boolean equals(java.lang.Object)>
<soot.coffi.CFG: soot.coffi.TypeStack smartPush(soot.coffi.TypeStack,soot.Type)>/java.lang.Object.equals/0	<soot.ArrayType: boolean equals(java.lang.Object)>
<soot.coffi.CFG: soot.coffi.TypeStack smartPush(soot.coffi.TypeStack,soot.Type)>/java.lang.Object.equals/0	<soot.DoubleType: boolean equals(java.lang.Object)>
<soot.coffi.CFG: soot.coffi.TypeStack smartPush(soot.coffi.TypeStack,soot.Type)>/java.lang.Object.equals/0	<soot.FloatType: boolean equals(java.lang.Object)>
<soot.coffi.CFG: soot.coffi.TypeStack smartPush(soot.coffi.TypeStack,soot.Type)>/java.lang.Object.equals/0	<soot.LongType: boolean equals(java.lang.Object)>
<soot.coffi.CFG: soot.coffi.TypeStack smartPush(soot.coffi.TypeStack,soot.Type)>/java.lang.Object.equals/0	<soot.RefType: boolean equals(java.lang.Object)>
<soot.coffi.CFG: soot.coffi.TypeStack smartPush(soot.coffi.TypeStack,soot.Type)>/java.lang.Object.equals/1	<soot.ArrayType: boolean equals(java.lang.Object)>
<soot.coffi.CFG: soot.coffi.TypeStack smartPush(soot.coffi.TypeStack,soot.Type)>/java.lang.Object.equals/1	<soot.DoubleType: boolean equals(java.lang.Object)>
<soot.coffi.CFG: soot.coffi.TypeStack smartPush(soot.coffi.TypeStack,soot.Type)>/java.lang.Object.equals/1	<soot.FloatType: boolean equals(java.lang.Object)>
<soot.coffi.CFG: soot.coffi.TypeStack smartPush(soot.coffi.TypeStack,soot.Type)>/java.lang.Object.equals/1	<soot.RefType: boolean equals(java.lang.Object)>
<soot.jimple.toolkits.callgraph.ContextInsensitiveContextManager: void addVirtualEdge(soot.MethodOrMethodContext,soot.Unit,soot.SootMethod,soot.Kind,soot.Context)>/soot.MethodOrMethodContext.method/0	<soot.SootMethod: soot.SootMethod method()>
<soot.jimple.toolkits.callgraph.OnFlyCallGraphBuilder: void findReceivers(soot.SootMethod,soot.Body)>/soot.SootMethod.getSignature/0	<soot.SootMethod: java.lang.String getSignature()>
<soot.jimple.toolkits.callgraph.OnFlyCallGraphBuilder: void findReceivers(soot.SootMethod,soot.Body)>/soot.SootMethod.getSignature/1	<soot.SootMethod: java.lang.String getSignature()>
<soot.jimple.toolkits.callgraph.OnFlyCallGraphBuilder: void findReceivers(soot.SootMethod,soot.Body)>/soot.SootMethod.getSignature/2	<soot.SootMethod: java.lang.String getSignature()>
<soot.jimple.toolkits.callgraph.OnFlyCallGraphBuilder: void findReceivers(soot.SootMethod,soot.Body)>/soot.SootMethod.getSignature/3	<soot.SootMethod: java.lang.String getSignature()>
<soot.jimple.toolkits.callgraph.OnFlyCallGraphBuilder: void getImplicitTargets(soot.SootMethod)>/soot.SootMethod.getSignature/0	<soot.SootMethod: java.lang.String getSignature()>
<soot.jimple.toolkits.callgraph.OnFlyCallGraphBuilder: void getImplicitTargets(soot.SootMethod)>/soot.SootMethod.getSignature/1	<soot.SootMethod: java.lang.String getSignature()>
<soot.jimple.toolkits.callgraph.VirtualCalls: soot.SootMethod resolveSpecial(soot.jimple.SpecialInvokeExpr,soot.util.NumberedString,soot.SootMethod)>/soot.SootClass.getType/1	<soot.SootClass: soot.RefType getType()>
<soot.jimple.toolkits.callgraph.VirtualCalls: soot.SootMethod resolveSpecial(soot.jimple.SpecialInvokeExpr,soot.util.NumberedString,soot.SootMethod)>/soot.SootClass.getType/3	<soot.SootClass: soot.RefType getType()>
<soot.jimple.toolkits.callgraph.VirtualCalls: soot.SootMethod resolveSpecial(soot.jimple.SpecialInvokeExpr,soot.util.NumberedString,soot.SootMethod)>/soot.SootMethod.getDeclaringClass/1	<soot.SootMethod: soot.SootClass getDeclaringClass()>
<soot.jimple.toolkits.callgraph.VirtualCalls: soot.SootMethod resolveSpecial(soot.jimple.SpecialInvokeExpr,soot.util.NumberedString,soot.SootMethod)>/soot.SootMethod.getDeclaringClass/3	<soot.SootMethod: soot.SootClass getDeclaringClass()>
<soot.jimple.toolkits.callgraph.VirtualCalls: soot.SootMethod resolveSpecial(soot.jimple.SpecialInvokeExpr,soot.util.NumberedString,soot.SootMethod)>/soot.SootMethod.getName/0	<soot.SootMethod: java.lang.String getName()>
<java.io.BufferedInputStream: int read(byte[],int,int)>/java.io.InputStream.available/0	<java.io.FilterInputStream: int available()>
<java.io.FilterInputStream: int available()>/java.io.InputStream.available/0	<java.util.zip.ZipFile$1: int available()>
<java.io.FilterInputStream: int available()>/java.io.InputStream.available/0	<java.util.zip.ZipFile$ZipFileInputStream: int available()>
<java.io.FilterInputStream: int read(byte[],int,int)>/java.io.InputStream.read/0	<java.util.zip.InflaterInputStream: int read(byte[],int,int)>
<java.io.FilterInputStream: int read(byte[],int,int)>/java.io.InputStream.read/0	<java.util.zip.ZipFile$ZipFileInputStream: int read(byte[],int,int)>
<java.io.FilterInputStream: void close()>/java.io.InputStream.close/0	<java.util.zip.ZipFile$1: void close()>
<java.io.FilterInputStream: void close()>/java.io.InputStream.close/0	<java.util.zip.ZipFile$ZipFileInputStream: void close()>
<org.python.core.Py: org.python.core.PyObject makeClass(java.lang.String,org.python.core.PyObject[],org.python.core.PyCode,org.python.core.PyObject,java.lang.Class,org.python.core.PyObject[])>/org.python.core.PyObject.__finditem__/0	<org.python.core.PyStringMap: org.python.core.PyObject __finditem__(java.lang.String)>
<org.python.core.Py: org.python.core.PyObject makeClass(java.lang.String,org.python.core.PyObject[],org.python.core.PyCode,org.python.core.PyObject,java.lang.Class,org.python.core.PyObject[])>/org.python.core.PyObject.__setitem__/0	<org.python.core.PyStringMap: void __setitem__(java.lang.String,org.python.core.PyObject)>
<org.python.core.PyClass: void findModule(org.python.core.PyObject)>/org.python.core.PyObject.__finditem__/0	<org.python.core.PyStringMap: org.python.core.PyObject __finditem__(java.lang.String)>
<org.python.core.PyClass: void findModule(org.python.core.PyObject)>/org.python.core.PyObject.__setitem__/0	<org.python.core.PyStringMap: void __setitem__(java.lang.String,org.python.core.PyObject)>
<org.python.core.PyClass: void init(java.lang.String,org.python.core.PyTuple,org.python.core.PyObject)>/org.python.core.PyObject.__finditem__/4	<org.python.core.PyStringMap: org.python.core.PyObject __finditem__(java.lang.String)>
<org.python.core.PyClass: void init(java.lang.String,org.python.core.PyTuple,org.python.core.PyObject)>/org.python.core.PyObject.__setitem__/1	<org.python.core.PyStringMap: void __setitem__(java.lang.String,org.python.core.PyObject)>
<org.python.parser.ast.Index: void traverse(org.python.parser.ast.VisitorIF)>/org.python.parser.ast.exprType.accept/0	<org.python.parser.ast.Attribute: java.lang.Object accept(org.python.parser.ast.VisitorIF)>
<org.python.parser.ast.Index: void traverse(org.python.parser.ast.VisitorIF)>/org.python.parser.ast.exprType.accept/0	<org.python.parser.ast.BinOp: java.lang.Object accept(org.python.parser.ast.VisitorIF)>
<org.python.parser.ast.Index: void traverse(org.python.parser.ast.VisitorIF)>/org.python.parser.ast.exprType.accept/0	<org.python.parser.ast.Call: java.lang.Object accept(org.python.parser.ast.VisitorIF)>
<org.python.parser.ast.Index: void traverse(org.python.parser.ast.VisitorIF)>/org.python.parser.ast.exprType.accept/0	<org.python.parser.ast.Name: java.lang.Object accept(org.python.parser.ast.VisitorIF)>
<org.python.parser.ast.Index: void traverse(org.python.parser.ast.VisitorIF)>/org.python.parser.ast.exprType.accept/0	<org.python.parser.ast.Num: java.lang.Object accept(org.python.parser.ast.VisitorIF)>
<org.python.parser.ast.Index: void traverse(org.python.parser.ast.VisitorIF)>/org.python.parser.ast.exprType.accept/0	<org.python.parser.ast.Str: java.lang.Object accept(org.python.parser.ast.VisitorIF)>
<org.python.parser.ast.Index: void traverse(org.python.parser.ast.VisitorIF)>/org.python.parser.ast.exprType.accept/0	<org.python.parser.ast.Subscript: java.lang.Object accept(org.python.parser.ast.VisitorIF)>
<org.python.parser.ast.Index: void traverse(org.python.parser.ast.VisitorIF)>/org.python.parser.ast.exprType.accept/0	<org.python.parser.ast.UnaryOp: java.lang.Object accept(org.python.parser.ast.VisitorIF)>
<org.python.parser.ast.Slice: void traverse(org.python.parser.ast.VisitorIF)>/org.python.parser.ast.exprType.accept/0	<org.python.parser.ast.BinOp: java.lang.Object accept(org.python.parser.ast.VisitorIF)>
<org.python.parser.ast.Slice: void traverse(org.python.parser.ast.VisitorIF)>/org.python.parser.ast.exprType.accept/0	<org.python.parser.ast.Call: java.lang.Object accept(org.python.parser.ast.VisitorIF)>
<org.python.parser.ast.Slice: void traverse(org.python.parser.ast.VisitorIF)>/org.python.parser.ast.exprType.accept/0	<org.python.parser.ast.Name: java.lang.Object accept(org.python.parser.ast.VisitorIF)>
<org.python.parser.ast.Slice: void traverse(org.python.parser.ast.VisitorIF)>/org.python.parser.ast.exprType.accept/0	<org.python.parser.ast.Num: java.lang.Object accept(org.python.parser.ast.VisitorIF)>
<org.python.parser.ast.Slice: void traverse(org.python.parser.ast.VisitorIF)>/org.python.parser.ast.exprType.accept/0	<org.python.parser.ast.UnaryOp: java.lang.Object accept(org.python.parser.ast.VisitorIF)>
<org.python.parser.ast.Slice: void traverse(org.python.parser.ast.VisitorIF)>/org.python.parser.ast.exprType.accept/1	<org.python.parser.ast.BinOp: java.lang.Object accept(org.python.parser.ast.VisitorIF)>
<org.python.parser.ast.Slice: void traverse(org.python.parser.ast.VisitorIF)>/org.python.parser.ast.exprType.accept/1	<org.python.parser.ast.Name: java.lang.Object accept(org.python.parser.ast.VisitorIF)>
<org.python.parser.ast.Slice: void traverse(org.python.parser.ast.VisitorIF)>/org.python.parser.ast.exprType.accept/1	<org.python.parser.ast.Num: java.lang.Object accept(org.python.parser.ast.VisitorIF)>
<org.python.parser.ast.Slice: void traverse(org.python.parser.ast.VisitorIF)>/org.python.parser.ast.exprType.accept/1	<org.python.parser.ast.UnaryOp: java.lang.Object accept(org.python.parser.ast.VisitorIF)>
<edu.umd.cs.findbugs.PluginLoader: edu.umd.cs.findbugs.plan.DetectorFactorySelector getConstraintSelector(org.dom4j.Element,edu.umd.cs.findbugs.Plugin,java.lang.String,java.lang.String)>/org.dom4j.Element.selectSingleNode/0	<org.dom4j.tree.AbstractNode: org.dom4j.Node selectSingleNode(java.lang.String)>
<edu.umd.cs.findbugs.PluginLoader: edu.umd.cs.findbugs.plan.DetectorFactorySelector getConstraintSelector(org.dom4j.Element,edu.umd.cs.findbugs.Plugin,java.lang.String,java.lang.String)>/org.dom4j.Element.selectSingleNode/1	<org.dom4j.tree.AbstractNode: org.dom4j.Node selectSingleNode(java.lang.String)>
<edu.umd.cs.findbugs.PluginLoader: edu.umd.cs.findbugs.plan.DetectorFactorySelector getConstraintSelector(org.dom4j.Element,edu.umd.cs.findbugs.Plugin,java.lang.String,java.lang.String)>/org.dom4j.Node.valueOf/0	<org.dom4j.tree.AbstractNode: java.lang.String valueOf(java.lang.String)>
<edu.umd.cs.findbugs.PluginLoader: edu.umd.cs.findbugs.plan.DetectorFactorySelector getConstraintSelector(org.dom4j.Element,edu.umd.cs.findbugs.Plugin,java.lang.String,java.lang.String)>/org.dom4j.Node.valueOf/1	<org.dom4j.tree.AbstractNode: java.lang.String valueOf(java.lang.String)>
<edu.umd.cs.findbugs.PluginLoader: edu.umd.cs.findbugs.plan.DetectorFactorySelector getConstraintSelector(org.dom4j.Element,edu.umd.cs.findbugs.Plugin,java.lang.String,java.lang.String)>/org.dom4j.Node.valueOf/2	<org.dom4j.tree.AbstractNode: java.lang.String valueOf(java.lang.String)>
<edu.umd.cs.findbugs.PluginLoader: java.lang.String getChildText(org.dom4j.Node,java.lang.String)>/org.dom4j.Node.getText/0	<org.dom4j.tree.DefaultElement: java.lang.String getText()>
<edu.umd.cs.findbugs.PluginLoader: void init()>/org.dom4j.Element.getName/0	<org.dom4j.tree.AbstractElement: java.lang.String getName()>
<edu.umd.cs.findbugs.PluginLoader: void init()>/org.dom4j.Element.getText/0	<org.dom4j.tree.DefaultElement: java.lang.String getText()>
<edu.umd.cs.findbugs.PluginLoader: void init()>/org.dom4j.Node.getText/0	<org.dom4j.tree.DefaultElement: java.lang.String getText()>
<edu.umd.cs.findbugs.PluginLoader: void init()>/org.dom4j.Node.getText/1	<org.dom4j.tree.DefaultElement: java.lang.String getText()>
<edu.umd.cs.findbugs.ba.AnnotationDatabase: edu.umd.cs.findbugs.ba.AnnotationEnumeration getUncachedResolvedAnnotation(java.lang.Object,boolean)>/edu.umd.cs.findbugs.ba.XMethod.getClassName/1	<edu.umd.cs.findbugs.ba.AbstractClassMember: java.lang.String getClassName()>
<edu.umd.cs.findbugs.ba.AnnotationDatabase: edu.umd.cs.findbugs.ba.AnnotationEnumeration getUncachedResolvedAnnotation(java.lang.Object,boolean)>/edu.umd.cs.findbugs.ba.XMethod.getName/0	<edu.umd.cs.findbugs.ba.AbstractClassMember: java.lang.String getName()>
<edu.umd.cs.findbugs.ba.NullnessAnnotationDatabase: edu.umd.cs.findbugs.ba.NullnessAnnotation getResolvedAnnotation(java.lang.Object,boolean)>/edu.umd.cs.findbugs.ba.XMethod.getName/0	<edu.umd.cs.findbugs.ba.AbstractClassMember: java.lang.String getName()>
<edu.umd.cs.findbugs.ba.NullnessAnnotationDatabase: edu.umd.cs.findbugs.ba.NullnessAnnotation getResolvedAnnotation(java.lang.Object,boolean)>/edu.umd.cs.findbugs.ba.XMethod.getName/1	<edu.umd.cs.findbugs.ba.AbstractClassMember: java.lang.String getName()>
<edu.umd.cs.findbugs.ba.NullnessAnnotationDatabase: edu.umd.cs.findbugs.ba.NullnessAnnotation getResolvedAnnotation(java.lang.Object,boolean)>/edu.umd.cs.findbugs.ba.XMethod.getName/2	<edu.umd.cs.findbugs.ba.AbstractClassMember: java.lang.String getName()>
<edu.umd.cs.findbugs.ba.PruneUnconditionalExceptionThrowerEdges: void execute()>/edu.umd.cs.findbugs.ba.XMethod.getClassName/0	<edu.umd.cs.findbugs.ba.AbstractClassMember: java.lang.String getClassName()>
<edu.umd.cs.findbugs.ba.PruneUnconditionalExceptionThrowerEdges: void execute()>/edu.umd.cs.findbugs.ba.XMethod.getName/0	<edu.umd.cs.findbugs.ba.AbstractClassMember: java.lang.String getName()>
<edu.umd.cs.findbugs.ba.PruneUnconditionalExceptionThrowerEdges: void execute()>/edu.umd.cs.findbugs.ba.XMethod.getSignature/0	<edu.umd.cs.findbugs.ba.AbstractClassMember: java.lang.String getSignature()>
<edu.umd.cs.findbugs.ba.XFactory: edu.umd.cs.findbugs.ba.XMethod resolve(edu.umd.cs.findbugs.ba.XMethod)>/edu.umd.cs.findbugs.ba.XMethod.isResolved/1	<edu.umd.cs.findbugs.ba.AbstractClassMember: boolean isResolved()>
<edu.umd.cs.findbugs.ba.XFactory: void addCalledMethod(edu.umd.cs.findbugs.ba.XMethod)>/edu.umd.cs.findbugs.ba.XMethod.isResolved/0	<edu.umd.cs.findbugs.ba.AbstractClassMember: boolean isResolved()>
<edu.umd.cs.findbugs.ba.deref.UnconditionalValueDerefAnalysis: void checkNonNullParams(edu.umd.cs.findbugs.ba.Location,edu.umd.cs.findbugs.ba.vna.ValueNumberFrame,edu.umd.cs.findbugs.ba.deref.UnconditionalValueDerefSet)>/edu.umd.cs.findbugs.ba.XMethod.getSignature/0	<edu.umd.cs.findbugs.ba.AbstractClassMember: java.lang.String getSignature()>
<edu.umd.cs.findbugs.detect.InfiniteRecursiveLoop: void sawOpcode(int)>/edu.umd.cs.findbugs.ba.XMethod.getClassName/0	<edu.umd.cs.findbugs.ba.AbstractClassMember: java.lang.String getClassName()>
<edu.umd.cs.findbugs.detect.LazyInit: void <clinit>()>/edu.umd.cs.findbugs.ba.bcp.ByteCodePattern.add/1	<edu.umd.cs.findbugs.ba.bcp.ByteCodePattern: edu.umd.cs.findbugs.ba.bcp.ByteCodePattern add(edu.umd.cs.findbugs.ba.bcp.PatternElement)>
<edu.umd.cs.findbugs.detect.LazyInit: void <clinit>()>/edu.umd.cs.findbugs.ba.bcp.ByteCodePattern.add/2	<edu.umd.cs.findbugs.ba.bcp.ByteCodePattern: edu.umd.cs.findbugs.ba.bcp.ByteCodePattern add(edu.umd.cs.findbugs.ba.bcp.PatternElement)>
<edu.umd.cs.findbugs.detect.LazyInit: void <clinit>()>/edu.umd.cs.findbugs.ba.bcp.ByteCodePattern.add/3	<edu.umd.cs.findbugs.ba.bcp.ByteCodePattern: edu.umd.cs.findbugs.ba.bcp.ByteCodePattern add(edu.umd.cs.findbugs.ba.bcp.PatternElement)>
<java.util.regex.Pattern$BmpCharProperty: boolean match(java.util.regex.Matcher,int,java.lang.CharSequence)>/java.util.regex.Pattern$BmpCharProperty.isSatisfiedBy/0	<java.util.regex.Pattern$BitClass: boolean isSatisfiedBy(int)>
<java.util.regex.Pattern$CharProperty$1: boolean isSatisfiedBy(int)>/java.util.regex.Pattern$CharProperty.isSatisfiedBy/0	<java.util.regex.Pattern$BitClass: boolean isSatisfiedBy(int)>
<org.dom4j.io.SAXReader: org.dom4j.Document read(java.net.URL)>/java.net.URL.toExternalForm/0	<java.net.URL: java.lang.String toExternalForm()>
<sun.nio.cs.StreamDecoder: int implRead(char[],int,int)>/java.nio.charset.CoderResult.isOverflow/0	<java.nio.charset.CoderResult: boolean isOverflow()>
<sun.nio.cs.StreamEncoder: void flushLeftoverChar(java.nio.CharBuffer,boolean)>/java.nio.charset.CharsetEncoder.encode/0	<java.nio.charset.CharsetEncoder: java.nio.charset.CoderResult encode(java.nio.CharBuffer,java.nio.ByteBuffer,boolean)>
<sun.nio.cs.StreamEncoder: void flushLeftoverChar(java.nio.CharBuffer,boolean)>/java.nio.charset.CoderResult.isUnderflow/0	<java.nio.charset.CoderResult: boolean isUnderflow()>
<sun.nio.cs.StreamEncoder: void implClose()>/java.nio.charset.CharsetEncoder.flush/0	<java.nio.charset.CharsetEncoder: java.nio.charset.CoderResult flush(java.nio.ByteBuffer)>
<sun.nio.cs.StreamEncoder: void implClose()>/java.nio.charset.CoderResult.isUnderflow/0	<java.nio.charset.CoderResult: boolean isUnderflow()>
